Address A,Address B,Packets,Bytes,Packets A → B,Bytes A → B,Packets B → A,Bytes B → A,Rel Start,Duration,Bits/s A → B,Bits/s B → A
43.249.73.33,167.235.145.223,36,26304,24,14700,12,11604,5.549878,77.228594,1522,1202
43.249.74.22,167.235.145.223,720,1286630,305,21681,415,1264949,5.671122,19.213224,9027,526699
43.249.74.23,167.235.145.223,291,1709146,173,14543,118,1694603,10.59688,60.232475,1931,225074
43.249.74.24,167.235.145.223,713,1325491,294,20955,419,1304536,76.695941,2.25927,74200,4619318
43.249.74.28,167.235.145.223,824,1556363,361,25446,463,1530917,28.579439,2.179656,93394,5618930
43.249.74.31,167.235.145.223,712,1316389,290,20760,422,1295629,40.666806,2.254448,73667,4597591
43.249.74.45,167.235.145.223,723,1216256,321,23151,402,1193105,16.575199,66.335709,2791,143886
43.249.74.50,167.235.145.223,728,1368800,296,21087,432,1347713,4.565026,60.913257,2769,177000
43.249.74.52,167.235.145.223,612,1031880,256,18516,356,1013364,34.591077,2.249289,65855,3604210
43.249.74.61,167.235.145.223,42,30688,28,17150,14,13538,4.300551,78.313914,1751,1382
43.249.74.64,167.235.145.223,731,1266300,320,22740,411,1243560,52.671263,2.274478,79983,4373961
43.249.74.66,167.235.145.223,757,1412964,323,22869,434,1390095,46.634891,2.252138,81234,4937867
43.249.74.67,167.235.145.223,754,1355326,335,23661,419,1331665,37.419931,29.430115,6431,361987
43.249.74.69,167.235.145.223,697,1239866,293,20889,404,1218977,58.649892,2.244766,74445,4344246
43.249.74.72,167.235.145.223,721,1347201,302,21552,419,1325649,70.726995,2.156318,79958,4918194
45.143.200.46,167.235.145.223,3,162,2,108,1,54,82.511714,0.035568,24291,12145
46.103.88.74,167.235.145.223,595,381180,319,113250,276,267930,3.935815,76.638051,11821,27968
60.249.243.247,167.235.145.223,26,4644,12,2050,14,2594,52.477526,5.07516,3231,4088
77.90.185.76,167.235.145.223,3,162,2,108,1,54,63.836777,0.014012,61661,30830
78.128.113.150,167.235.145.223,6,324,4,216,2,108,9.21547,71.317958,24,12
94.102.61.30,167.235.145.223,2,198,1,85,1,113,55.413189,2.40E-05,,
104.156.92.21,167.235.145.223,52,1331303,27,2875,25,1328428,14.198532,60.024073,383,177052
104.156.92.23,167.235.145.223,184,1290593,88,7375,96,1283218,75.293824,0.20714,284831,49559447
104.156.92.24,167.235.145.223,131,1169268,63,5693,68,1163575,38.195096,0.138502,328832,67209137
104.156.92.30,167.235.145.223,2,120,1,66,1,54,71.788088,9.00E-06,,
104.156.92.32,167.235.145.223,141,1269732,68,6092,73,1263640,20.188911,60.064246,811,168305
104.156.92.35,167.235.145.223,148,1094845,68,6023,80,1088822,62.196646,0.181346,265702,48032909
104.156.92.41,167.235.145.223,2,120,1,66,1,54,36.713703,1.60E-05,,
104.156.92.43,167.235.145.223,138,1257339,65,5857,73,1251482,82.90785,0.146999,318750,68108327
104.156.92.46,167.235.145.223,142,1372415,69,6158,73,1366257,50.189456,0.139816,352348,78174572
104.156.92.50,167.235.145.223,40,23686,24,10898,16,12788,55.63638,27.188399,3206,3762
104.156.92.51,167.235.145.223,199,1207108,98,8072,101,1199036,2.192617,60.097838,1074,159611
104.156.92.56,167.235.145.223,187,1248566,87,7346,100,1241220,8.194031,60.096064,977,165231
104.156.92.61,167.235.145.223,142,1305894,71,6221,71,1299673,33.866427,34.462189,1444,301704
104.156.92.65,167.235.145.223,2,120,1,66,1,54,16.210984,2.40E-05,,
104.156.92.68,167.235.145.223,170,1461783,89,7409,81,1454374,74.191504,0.140438,422051,82847890
104.156.92.73,167.235.145.223,146,1236767,74,6488,72,1230279,80.190034,0.143187,362491,68736910
104.156.92.74,167.235.145.223,2,120,1,66,1,54,39.936206,2.00E-05,,
104.156.92.78,167.235.145.223,144,1309135,71,6322,73,1302813,67.641105,0.143287,352969,72738657
104.156.92.79,167.235.145.223,60,43440,40,24180,20,19260,3.427712,77.846271,2484,1979
104.156.92.80,167.235.145.223,182,1453551,83,7013,99,1446538,32.200759,0.209581,267696,55216379
104.156.92.82,167.235.145.223,144,1242651,72,6356,72,1236295,26.194147,0.13574,374598,72862531
104.156.92.83,167.235.145.223,2,120,1,66,1,54,63.734686,1.50E-05,,
104.156.93.20,167.235.145.223,2,120,1,66,1,54,61.294837,2.60E-05,,
104.156.93.22,167.235.145.223,2,120,1,66,1,54,64.599205,1.10E-05,,
104.156.93.33,167.235.145.223,2,120,1,66,1,54,49.229743,1.00E-05,,
104.156.93.36,167.235.145.223,2,120,1,66,1,54,0.941763,1.70E-05,,
104.156.93.45,167.235.145.223,2,120,1,66,1,54,33.695501,1.30E-05,,
104.156.93.56,167.235.145.223,2,120,1,66,1,54,13.387982,1.00E-05,,
104.156.93.67,167.235.145.223,42,30640,28,17150,14,13490,1.004179,77.648214,1766,1389
104.156.93.79,167.235.145.223,2,120,1,66,1,54,30.708776,1.20E-05,,
104.156.93.93,167.235.145.223,2,120,1,66,1,54,82.850082,7.00E-06,,
104.156.93.99,167.235.145.223,2,120,1,66,1,54,4.914503,1.70E-05,,
104.156.93.100,167.235.145.223,2,120,1,66,1,54,71.674365,7.00E-06,,
104.156.93.106,167.235.145.223,2,120,1,66,1,54,75.842084,1.50E-05,,
104.156.93.107,167.235.145.223,2,120,1,66,1,54,17.646674,1.40E-05,,
104.156.93.110,167.235.145.223,2,120,1,66,1,54,51.774515,1.80E-05,,
106.12.167.196,167.235.145.223,14,1980,5,1336,9,644,16.910716,65.1531,164,79
108.162.220.66,167.235.145.223,443,2538298,180,14086,263,2524212,16.92997,63.08854,1786,320085
108.162.220.71,167.235.145.223,6,427,2,132,4,295,1.895472,29.915915,35,78
108.162.220.77,167.235.145.223,6,427,2,132,4,295,26.028651,29.964883,35,78
108.162.220.78,167.235.145.223,215,2667866,104,9070,111,2658796,11.605233,62.39849,1162,340879
108.162.220.86,167.235.145.223,6,427,2,132,4,295,25.451577,29.942922,35,78
108.162.220.88,167.235.145.223,1088,2181540,508,34834,580,2146706,37.475399,30.647377,9092,560362
108.162.220.89,167.235.145.223,331,2131801,151,11495,180,2120306,37.753604,30.232148,3041,561073
108.162.220.90,167.235.145.223,375,231386,250,115442,125,115944,0.315569,81.33392,11354,11404
108.162.220.91,167.235.145.223,1724,7794670,1112,476978,612,7317692,0.245782,82.182569,46431,712335
108.162.220.98,167.235.145.223,294,4930721,154,14047,140,4916674,41.713494,32.387717,3469,1214453
108.162.220.100,167.235.145.223,6,427,2,132,4,295,14.038433,29.979118,35,78
108.162.220.107,167.235.145.223,244,7406350,114,10145,130,7396205,7.877325,65.689915,1235,900741
108.162.220.113,167.235.145.223,2581,5697823,1183,80913,1398,5616910,25.577979,31.049569,20847,1447211
108.162.221.3,167.235.145.223,925,574917,616,290669,309,284248,0.296048,82.197466,28289,27664
108.162.221.4,167.235.145.223,1077,673210,718,340928,359,332282,0.160073,82.913411,32894,32060
108.162.221.10,167.235.145.223,189,2322697,93,8414,96,2314283,36.163235,31.904176,2109,580308
108.162.221.16,167.235.145.223,515,4266620,220,16704,295,4249916,13.474687,60.316875,2215,563678
108.162.221.18,167.235.145.223,504,2614661,234,17711,270,2596950,65.702749,2.406907,58867,8631658
108.162.221.24,167.235.145.223,862,11300510,326,26987,536,11273523,1.042005,77.6842,2779,1160959
108.162.221.28,167.235.145.223,287,4619091,132,10832,155,4608259,80.947972,1.658177,52259,22232893
108.162.221.33,167.235.145.223,311,4644892,150,12084,161,4632808,1.738611,65.715963,1471,563979
108.162.221.35,167.235.145.223,237,1327744,114,8179,123,1319565,3.411155,60.016471,1090,175893
108.162.221.52,167.235.145.223,1331,6524935,619,44148,712,6480787,58.074078,4.105315,86030,12629066
108.162.221.55,167.235.145.223,199,2083898,95,7799,104,2076099,55.751676,0.14312,435941,116048015
108.162.221.59,167.235.145.223,955,6771367,463,33828,492,6737539,4.927876,62.297946,4344,865202
108.162.221.61,167.235.145.223,998,7117476,393,28957,605,7088519,16.054443,63.48719,3648,893221
108.162.221.63,167.235.145.223,354,4118236,151,11461,203,4106775,0.615731,60.719327,1510,541083
108.162.221.65,167.235.145.223,1767,4227849,796,55371,971,4172478,19.624172,60.17373,7361,554724
108.162.221.69,167.235.145.223,148,6333206,47,5692,101,6327514,13.185176,54.784335,831,923988
108.162.221.72,167.235.145.223,303,4596146,150,12084,153,4584062,73.589349,0.200253,482749,183130819
108.162.221.78,167.235.145.223,392,7480289,190,15764,202,7464525,47.14474,33.031906,3817,1807833
108.162.221.98,167.235.145.223,6,427,2,132,4,295,2.054529,29.939059,35,78
108.162.221.102,167.235.145.223,1932,9963447,932,66418,1000,9897029,24.090045,38.155995,13925,2075066
108.162.221.103,167.235.145.223,208,1942835,104,8344,104,1934491,82.838637,0.143032,466692,108199060
108.162.221.104,167.235.145.223,92,1191718,35,3048,57,1188670,2.224459,60.016452,406,158445
108.162.221.105,167.235.145.223,182,2171536,89,8141,93,2163395,59.810578,2.230636,29197,7758845
108.162.221.110,167.235.145.223,6,427,2,132,4,295,1.048378,29.969978,35,78
108.162.221.113,167.235.145.223,6,427,2,132,4,295,20.238557,29.785065,35,79
108.162.221.119,167.235.145.223,202,2727314,98,8735,104,2718579,47.70228,32.339206,2160,672515
108.162.221.126,167.235.145.223,6,427,2,132,4,295,8.130281,29.856191,35,79
108.162.221.127,167.235.145.223,78,2460899,36,4001,42,2456898,5.960936,62.035979,515,316835
108.162.221.131,167.235.145.223,436,9175999,208,17445,228,9158554,18.987908,48.789636,2860,1501721
108.162.221.133,167.235.145.223,772,2921649,370,26696,402,2894953,29.853941,32.351911,6601,715865
108.162.221.135,167.235.145.223,1014,5088600,627,232008,387,4856592,0.344889,82.252146,22565,472361
108.162.221.136,167.235.145.223,751,2459949,486,219333,265,2240616,0.302583,82.476399,21274,217334
108.162.221.140,167.235.145.223,513,3543261,241,18090,272,3525171,31.482734,30.396014,4761,927798
108.162.221.141,167.235.145.223,34,1248054,10,1315,24,1246739,0.780217,60.016449,175,166186
108.162.221.143,167.235.145.223,170,1361604,82,6718,88,1354886,6.740911,60.059582,894,180472
108.162.221.148,167.235.145.223,311,4644860,153,12282,158,4632578,61.522123,0.26793,366722,138322039
108.162.221.150,167.235.145.223,1417,4910748,652,45216,765,4865532,7.746251,60.563266,5972,642704
108.162.221.155,167.235.145.223,1657,13828076,683,50953,974,13777123,52.392822,27.92616,14596,3946728
108.162.221.165,167.235.145.223,702,437954,468,221800,234,216154,0.169145,81.706055,21716,21164
108.162.221.166,167.235.145.223,1081,1921845,711,330335,370,1591510,0.241682,81.34715,32486,156515
108.162.221.170,167.235.145.223,405,7892419,196,16160,209,7876259,71.148677,3.14382,41121,20042518
108.162.226.143,167.235.145.223,612,778801,277,20951,335,757850,65.01948,18.019541,9301,336456
108.162.227.14,167.235.145.223,961,975072,397,29710,564,945362,22.864935,60.238503,3945,125549
108.162.227.20,167.235.145.223,53,28455,29,12815,24,15640,21.723442,61.045709,1679,2049
108.162.241.7,167.235.145.223,6,427,2,132,4,295,23.340904,29.285528,36,80
108.162.241.28,167.235.145.223,6,427,2,132,4,295,20.702438,29.280266,36,80
108.162.241.53,167.235.145.223,7,493,3,198,4,295,8.868088,29.201909,54,80
108.162.241.82,167.235.145.223,618,2250137,282,20097,336,2230040,52.383828,1.140384,140984,15644133
108.162.241.92,167.235.145.223,652,2213188,313,22141,339,2191047,79.627524,1.143655,154878,15326629
108.162.241.99,167.235.145.223,62,111421,20,2805,42,108616,82.475471,0.572212,39216,1518542
108.162.241.101,167.235.145.223,734,2637466,338,23791,396,2613675,49.609869,31.245054,6091,669206
108.162.241.107,167.235.145.223,714,4358236,309,22709,405,4335527,25.583384,48.14476,3773,720415
108.162.241.110,167.235.145.223,6,427,2,132,4,295,2.875376,29.180102,36,80
108.162.241.120,167.235.145.223,6,427,2,132,4,295,14.847819,29.192078,36,80
108.162.241.123,167.235.145.223,682,2513541,317,22405,365,2491136,13.591718,60.415016,2966,329869
108.162.241.124,167.235.145.223,656,2807103,290,20625,366,2786478,28.320689,31.181214,5291,714911
108.162.241.131,167.235.145.223,700,2285716,323,22801,377,2262915,7.648699,60.452501,3017,299463
108.162.241.140,167.235.145.223,42,26237,28,13258,14,12979,4.109031,78.310098,1354,1325
108.162.241.164,167.235.145.223,644,2414575,294,20889,350,2393686,70.443247,1.172179,142565,16336658
108.162.241.186,167.235.145.223,702,2523855,318,22471,384,2501384,31.593286,31.229393,5756,640776
108.162.241.216,167.235.145.223,153,2416193,78,5980,75,2410213,29.36013,26.463213,1807,728622
108.162.241.221,167.235.145.223,711,2361760,330,23265,381,2338495,4.270156,60.45422,3078,309456
108.162.241.224,167.235.145.223,591,2157972,263,18843,328,2139129,16.28691,60.407028,2495,283295
108.162.241.230,167.235.145.223,702,3854185,324,23703,378,3830482,22.30474,42.303204,4482,724386
108.162.241.239,167.235.145.223,643,2333148,271,19371,372,2313777,76.461,1.214445,127603,15241707
108.162.241.241,167.235.145.223,648,2475084,294,20887,354,2454197,67.654186,1.092869,152896,17965168
108.162.242.32,167.235.145.223,600,2450864,262,18777,338,2432087,10.270178,60.411068,2486,322071
108.162.242.40,167.235.145.223,115,2055126,46,3868,69,2051258,1.562581,60.115269,514,272976
108.162.242.50,167.235.145.223,6,427,2,132,4,295,5.32865,29.280335,36,80
108.162.242.51,167.235.145.223,637,2112762,306,21681,331,2091081,58.407948,1.098246,157931,15232150
108.162.242.57,167.235.145.223,643,2396461,289,20557,354,2375904,19.573376,60.403833,2722,314669
108.162.242.63,167.235.145.223,6,427,2,132,4,295,17.35075,29.272531,36,80
108.162.242.69,167.235.145.223,663,2415829,306,21681,357,2394148,46.361531,31.356306,5531,610823
108.162.242.75,167.235.145.223,608,2354931,267,19107,341,2335824,64.427262,1.102604,138631,16947691
108.162.242.89,167.235.145.223,6,427,2,132,4,295,26.878801,28.773448,36,82
108.162.242.93,167.235.145.223,803,2717336,376,26299,427,2691037,73.631852,1.365624,154062,15764438
108.162.242.95,167.235.145.223,620,2153836,292,20755,328,2133081,37.612684,31.142756,5331,547949
108.162.242.103,167.235.145.223,7,493,3,198,4,295,11.318423,29.300429,54,80
108.162.242.106,167.235.145.223,42,26198,28,13230,14,12968,1.430816,78.170875,1353,1327
108.162.242.112,167.235.145.223,708,2156639,342,24057,366,2132582,40.377637,31.249012,6158,545958
125.124.215.155,167.235.145.223,26,4644,12,2050,14,2594,34.261654,5.335093,3073,3889
140.248.69.21,167.235.145.223,247,2661889,122,10749,125,2651140,19.942578,36.090446,2382,587665
140.248.69.26,167.235.145.223,171,1096420,83,7082,88,1089338,61.786931,0.200909,281998,43376374
140.248.69.27,167.235.145.223,2,120,1,66,1,54,45.499147,2.20E-05,,
140.248.69.29,167.235.145.223,177,1247906,83,7082,94,1240824,7.854507,60.085883,942,165206
140.248.69.33,167.235.145.223,208,1310319,101,8270,107,1302049,68.004375,0.229959,287703,45296735
140.248.69.36,167.235.145.223,195,1206844,98,8072,97,1198772,1.960888,60.08967,1074,159597
140.248.69.38,167.235.145.223,201,1240397,98,8072,103,1232325,79.949025,0.227396,283980,43354324
140.248.69.39,167.235.145.223,2,120,1,66,1,54,71.850836,1.00E-05,,
140.248.69.41,167.235.145.223,193,1375724,96,7871,97,1367853,50.14664,0.201137,313060,54404828
140.248.69.42,167.235.145.223,53,1331369,28,2941,25,1328428,13.934527,60.026342,391,177046
140.248.69.43,167.235.145.223,42,30416,28,16926,14,13490,1.52336,78.07748,1734,1382
140.248.69.45,167.235.145.223,2,120,1,66,1,54,26.035649,9.00E-06,,
140.248.69.50,167.235.145.223,2,120,1,66,1,54,59.508133,1.30E-05,,
140.248.69.52,167.235.145.223,248,2622644,120,10617,128,2612027,37.959015,36.503733,2326,572440
140.248.74.20,167.235.145.223,23,9917,14,3649,9,6268,24.319557,19.28068,1514,2600
140.248.74.28,167.235.145.223,222,1284712,182,14283,40,1270429,40.683218,0.058577,1950663,173505505
140.248.74.31,167.235.145.223,318,1416437,257,61667,61,1354770,1.618141,81.309782,6067,133294
140.248.74.32,167.235.145.223,1196,7348520,1061,81602,135,7266918,41.116866,21.82801,29907,2663336
140.248.74.37,167.235.145.223,175,1175762,134,10904,41,1164858,16.655978,60.02831,1453,155241
140.248.74.46,167.235.145.223,2,120,1,66,1,54,77.713996,1.20E-05,,
140.248.74.47,167.235.145.223,2,120,1,66,1,54,41.524746,1.40E-05,,
140.248.74.51,167.235.145.223,1186,7619811,1043,80415,143,7539396,16.476184,17.871898,35996,3374860
140.248.74.52,167.235.145.223,248,1371314,202,15851,46,1355463,10.789616,60.034579,2112,180624
140.248.74.64,167.235.145.223,2,120,1,66,1,54,46.420756,3.10E-05,,
140.248.74.66,167.235.145.223,1212,8051816,1085,83180,127,7968636,10.040694,14.227547,46771,4480680
140.248.74.68,167.235.145.223,993,7824462,842,67122,151,7757340,65.661594,14.636788,36686,4239913
140.248.74.70,167.235.145.223,849,5337293,763,57938,86,5279355,0.107602,68.764555,6740,614194
140.248.74.75,167.235.145.223,2,120,1,66,1,54,77.726301,7.00E-06,,
140.248.74.82,167.235.145.223,197,1515468,150,11995,47,1503473,28.674156,0.057758,1661414,208244468
140.248.74.84,167.235.145.223,174,1229945,134,10859,40,1219086,52.601611,0.055729,1558829,175002027
140.248.74.87,167.235.145.223,634,5589943,526,41755,108,5548188,53.27912,8.671472,38521,5118566
140.248.74.89,167.235.145.223,2,120,1,66,1,54,57.262613,1.50E-05,,
140.248.74.97,167.235.145.223,2,120,1,66,1,54,65.996141,8.00E-06,,
140.248.74.103,167.235.145.223,2,120,1,66,1,54,55.023973,7.00E-06,,
140.248.74.117,167.235.145.223,839,6237142,692,56027,147,6181115,6.03001,76.868958,5830,643288
140.248.74.123,167.235.145.223,951,7299762,808,63268,143,7236494,72.180617,9.115089,55528,6351221
140.248.74.125,167.235.145.223,573,4796556,491,39907,82,4756649,1.885438,70.17717,4549,542244
140.248.74.127,167.235.145.223,2,120,1,66,1,54,76.536091,2.80E-05,,
140.248.74.132,167.235.145.223,191,1318732,150,12003,41,1306729,64.621951,0.054477,1762652,191894414
140.248.75.21,167.235.145.223,272,7206984,136,16072,136,7190912,28.637581,20.046749,6413,2869657
140.248.75.22,167.235.145.223,2,120,1,66,1,54,73.632855,9.00E-06,,
140.248.75.29,167.235.145.223,292,7393872,148,17658,144,7376214,22.560789,19.990574,7066,2951876
140.248.75.31,167.235.145.223,2,120,1,66,1,54,22.092281,2.00E-05,,
140.248.75.52,167.235.145.223,73,996281,38,4091,35,992190,34.565715,0.056865,575538,139585333
140.248.75.53,167.235.145.223,2,120,1,66,1,54,17.862706,1.90E-05,,
140.248.75.61,167.235.145.223,2,120,1,66,1,54,66.709547,1.20E-05,,
140.248.75.63,167.235.145.223,2,120,1,66,1,54,46.595288,2.10E-05,,
140.248.75.65,167.235.145.223,73,1141142,36,3815,37,1137327,82.998665,0.05442,560823,167192502
140.248.75.69,167.235.145.223,2,120,1,66,1,54,30.823623,1.10E-05,,
140.248.75.70,167.235.145.223,2,120,1,66,1,54,3.841718,1.80E-05,,
140.248.75.71,167.235.145.223,2,120,1,66,1,54,24.205824,1.20E-05,,
140.248.75.73,167.235.145.223,2,120,1,66,1,54,3.90564,3.80E-05,,
140.248.75.74,167.235.145.223,162,3683167,81,10240,81,3672927,77.102337,4.36695,18759,6728589
140.248.75.80,167.235.145.223,82,1244635,42,4355,40,1240280,22.741404,60.028417,580,165292
140.248.75.82,167.235.145.223,42,31104,28,17566,14,13538,4.471387,77.987227,1801,1388
140.248.75.87,167.235.145.223,2,120,1,66,1,54,7.060506,1.90E-05,,
140.248.75.92,167.235.145.223,277,6957344,144,16664,133,6940680,34.838682,19.798378,6733,2804544
140.248.75.93,167.235.145.223,221,5420251,116,13707,105,5406544,59.502192,16.44481,6668,2630152
140.248.75.98,167.235.145.223,2,120,1,66,1,54,33.590936,1.80E-05,,
140.248.75.103,167.235.145.223,2,120,1,66,1,54,21.020266,1.40E-05,,
140.248.75.110,167.235.145.223,124,2602423,63,6919,61,2595504,70.730728,11.859859,4667,1750782
140.248.75.116,167.235.145.223,81,1283868,41,4358,40,1279510,76.596294,0.05593,623350,183015912
140.248.83.24,167.235.145.223,232,2537088,111,10023,121,2527065,0.957622,69.154895,1159,292336
140.248.83.25,167.235.145.223,199,1403387,94,7808,105,1395579,53.768302,0.233792,267177,47754551
140.248.83.26,167.235.145.223,204,1246522,101,8169,103,1238353,25.570015,0.225171,290232,43996891
140.248.83.27,167.235.145.223,198,1173690,98,8003,100,1165687,34.366203,0.233004,274776,40022900
140.248.83.28,167.235.145.223,155,1225203,64,5759,91,1219444,41.604096,0.209434,219983,46580555
140.248.83.42,167.235.145.223,63,45632,42,25389,21,20243,0.866169,82.115106,2473,1972
140.248.83.45,167.235.145.223,12,5558,7,807,5,4751,83.055889,0.049221,131163,772190
140.248.83.47,167.235.145.223,180,1374866,85,7145,95,1367721,49.619117,0.194756,293495,56181930
140.248.83.48,167.235.145.223,197,1309593,99,8138,98,1301455,65.945008,0.200051,325437,52044928
140.248.83.51,167.235.145.223,192,1248896,97,8006,95,1240890,5.031438,60.09035,1065,165203
140.248.83.63,167.235.145.223,211,1464489,104,8399,107,1456090,70.888207,0.228088,294588,51071165
140.248.83.69,167.235.145.223,193,1273107,89,7409,104,1265698,17.210639,60.097721,986,168485
140.248.83.72,167.235.145.223,201,1240397,97,8006,104,1232391,78.127035,0.233667,274099,42193069
141.101.76.7,167.235.145.223,200,2083954,99,8053,101,2075901,58.698025,0.113876,565738,145835891
141.101.76.11,167.235.145.223,198,2393907,119,42789,79,2351118,1.26727,79.797623,4289,235708
141.101.76.12,167.235.145.223,51,31558,34,15814,17,15744,1.518943,78.09934,1619,1612
141.101.76.27,167.235.145.223,149,1312150,73,6302,76,1305848,75.830745,0.103525,486993,100910736
141.101.76.42,167.235.145.223,209,2316570,101,8185,108,2308385,82.528618,0.117474,557399,157201423
141.101.76.48,167.235.145.223,37,1188158,14,1732,23,1186426,1.490008,60.012842,230,158156
141.101.76.52,167.235.145.223,72,1459899,41,9978,31,1449921,11.001787,72.040982,1108,161010
141.101.76.53,167.235.145.223,27,16555,18,8218,9,8337,5.00305,72.032967,912,925
141.101.76.62,167.235.145.223,134,1091259,62,5605,72,1085654,1.949825,57.785953,775,150300
141.101.76.75,167.235.145.223,147,1360264,69,6038,78,1354226,18.116884,60.053138,804,180403
141.101.76.78,167.235.145.223,228,2387153,111,8845,117,2378308,46.54137,30.28791,2336,628186
141.101.76.81,167.235.145.223,129,82275,86,42447,43,39828,2.784972,78.155914,4344,4076
141.101.76.84,167.235.145.223,82,2764118,35,3178,47,2760940,2.347657,56.255357,451,392629
141.101.76.86,167.235.145.223,138,1199954,67,5906,71,1194048,72.121111,0.106271,444599,89887024
141.101.76.89,167.235.145.223,147,1266925,70,6158,77,1260767,19.378149,60.048996,820,167965
141.101.76.97,167.235.145.223,135,1244934,61,5510,74,1239424,24.994097,30.36301,1451,326561
141.101.76.100,167.235.145.223,144,1305804,69,6038,75,1299766,79.879464,0.102784,469956,101164850
141.101.76.106,167.235.145.223,275,4721050,124,10520,151,4710530,16.431977,63.822957,1318,590449
141.101.76.110,167.235.145.223,130,997512,63,5642,67,991870,45.895437,30.178922,1495,262930
141.101.76.114,167.235.145.223,138,1284354,62,5576,76,1278778,2.428567,60.046206,742,170372
141.101.76.125,167.235.145.223,140,1326656,62,5576,78,1321080,8.136951,60.049863,742,175997
141.101.76.126,167.235.145.223,6,427,2,132,4,295,20.268918,29.974347,35,78
141.101.76.128,167.235.145.223,148,1239830,73,6356,75,1233474,25.377067,30.151527,1686,327273
141.101.76.130,167.235.145.223,6,427,2,132,4,295,16.703355,29.535872,35,79
141.101.76.137,167.235.145.223,6,427,2,132,4,295,22.751912,29.866863,35,79
141.101.76.146,167.235.145.223,148,1507952,66,5840,82,1502112,28.863205,30.142723,1549,398666
141.101.76.151,167.235.145.223,7,493,3,198,4,295,28.732994,29.80176,53,79
141.101.76.155,167.235.145.223,133,1395521,56,5209,77,1390312,53.627505,0.107416,387949,103545989
141.101.76.163,167.235.145.223,141,1302626,65,5803,76,1296823,65.627486,0.101653,456690,102058807
141.101.76.165,167.235.145.223,266,4133770,157,44417,109,4089353,1.089779,79.201695,4486,413057
141.101.76.170,167.235.145.223,152,1369645,72,6265,80,1363380,47.623672,30.377775,1649,359046
141.101.76.176,167.235.145.223,263,4876801,114,9786,149,4867015,65.148656,3.119005,25100,12483506
141.101.76.178,167.235.145.223,304,4951978,146,11972,158,4940006,10.616912,63.657983,1504,620818
141.101.76.181,167.235.145.223,201,2304010,94,7723,107,2296287,76.543506,0.12238,504853,150108645
141.101.76.183,167.235.145.223,51,31720,34,15822,17,15898,3.158114,74.551732,1697,1705
141.101.76.185,167.235.145.223,242,4586183,98,8730,144,4577453,23.125278,33.180761,2104,1103640
141.101.76.201,167.235.145.223,6,427,2,132,4,295,26.259846,29.98182,35,78
141.101.76.202,167.235.145.223,274,4491896,127,10644,147,4481252,5.112876,63.217016,1346,567094
141.101.76.206,167.235.145.223,191,2068192,87,7132,104,2061060,20.282457,60.047562,950,274590
141.101.76.210,167.235.145.223,288,5191863,132,10974,156,5180889,47.169418,33.138943,2649,1250707
141.101.76.213,167.235.145.223,246,4421974,118,10719,128,4411255,13.424384,51.442595,1666,686008
141.101.76.214,167.235.145.223,7,493,3,198,4,295,8.315998,29.945695,52,78
141.101.76.216,167.235.145.223,6,427,2,132,4,295,28.925974,29.836826,35,79
141.101.76.224,167.235.145.223,196,2122881,91,7525,105,2115356,40.507087,30.279029,1988,558896
141.101.76.231,167.235.145.223,6,427,2,132,4,295,13.654813,29.827974,35,79
141.101.76.232,167.235.145.223,114,71655,76,36458,38,35197,0.095422,78.026928,3737,3608
141.101.76.234,167.235.145.223,42,26969,28,14000,14,12969,1.263527,78.012542,1435,1329
141.101.76.236,167.235.145.223,105,1197611,64,23376,41,1174235,3.331119,78.022237,2396,120400
141.101.76.238,167.235.145.223,292,5342759,129,10776,163,5331983,71.15967,3.13816,27470,13592635
141.101.76.244,167.235.145.223,141,4590931,68,8249,73,4582682,17.634009,60.00998,1099,610922
141.101.76.247,167.235.145.223,64,2051729,27,2583,37,2049146,2.263229,60.014831,344,273151
141.101.76.249,167.235.145.223,6,427,2,132,4,295,7.785111,29.935758,35,78
141.101.76.254,167.235.145.223,158,1448419,77,6620,81,1441799,31.382139,30.186466,1754,382104
141.101.77.6,167.235.145.223,80,2315013,38,3376,42,2311637,4.504904,60.015032,450,308141
141.101.77.11,167.235.145.223,6,427,2,132,4,295,10.747395,29.853467,35,79
141.101.77.14,167.235.145.223,6,427,2,132,4,295,14.613897,29.629535,35,79
141.101.77.15,167.235.145.223,140,1224179,67,5906,73,1218273,67.053114,0.102772,459736,94833067
141.101.77.20,167.235.145.223,84,51988,56,26040,28,25948,1.759598,80.932504,2573,2564
141.101.77.22,167.235.145.223,187,1390512,100,19109,87,1371403,1.938664,78.074234,1958,140522
141.101.77.24,167.235.145.223,82,2346415,41,3574,41,2342841,10.522844,60.017036,476,312290
141.101.77.26,167.235.145.223,271,4310839,135,11172,136,4299667,59.11612,3.311068,26993,10388592
141.101.77.30,167.235.145.223,159,1276656,77,6566,82,1270090,52.068775,30.403336,1727,334197
141.101.77.34,167.235.145.223,155,4954951,75,6561,80,4948390,26.029353,36.351063,1443,1089022
141.101.77.39,167.235.145.223,6,427,2,132,4,295,19.806519,29.696715,35,79
141.101.77.45,167.235.145.223,132,83621,88,42850,44,40771,3.061269,79.361138,4319,4109
141.101.77.47,167.235.145.223,7,493,3,198,4,295,22.990399,29.768512,53,79
141.101.77.52,167.235.145.223,253,4351822,114,9786,139,4342036,77.121286,3.254924,24052,10671919
141.101.77.58,167.235.145.223,6,427,2,132,4,295,2.288292,29.956193,35,78
141.101.77.63,167.235.145.223,311,5012701,159,13180,152,4999521,25.858901,30.517026,3455,1310618
141.101.77.66,167.235.145.223,6,427,2,132,4,295,7.778414,29.732909,35,79
141.101.96.11,167.235.145.223,205,2385523,86,7084,119,2378439,68.750105,0.190748,297104,99752091
141.101.96.17,167.235.145.223,6,427,2,132,4,295,2.79542,29.668019,35,79
141.101.96.37,167.235.145.223,6,427,2,132,4,295,14.926465,29.873383,35,79
141.101.96.40,167.235.145.223,42,25163,28,12180,14,12983,2.615183,78.055111,1248,1330
141.101.96.50,167.235.145.223,218,2386382,86,7084,132,2379298,44.738009,30.467794,1860,624737
141.101.96.85,167.235.145.223,216,2223527,91,7414,125,2216113,50.745119,30.383376,1952,583506
141.101.96.87,167.235.145.223,237,2330368,111,8734,126,2321634,63.288006,0.188576,370524,98491175
141.101.96.94,167.235.145.223,215,2316855,93,7546,122,2309309,80.758495,0.196729,306858,93908229
141.101.96.106,167.235.145.223,237,2426828,105,8338,132,2418490,8.790639,60.072039,1110,322078
141.101.96.110,167.235.145.223,241,2779636,111,8734,130,2770902,26.733655,30.268646,2308,732349
141.101.96.127,167.235.145.223,193,2122572,81,6754,112,2115818,38.747796,30.425775,1775,556322
141.101.96.142,167.235.145.223,231,2330003,106,8404,125,2321599,2.714939,60.072651,1119,309172
141.101.96.152,167.235.145.223,6,427,2,132,4,295,27.204514,29.569687,35,79
141.101.96.163,167.235.145.223,217,2133211,97,7810,120,2125401,14.714386,60.068968,1040,283061
141.101.96.174,167.235.145.223,185,2082853,85,7018,100,2075835,56.736181,0.134151,418513,123790951
141.101.96.177,167.235.145.223,199,2068739,92,7480,107,2061259,20.734054,60.049537,996,274607
141.101.96.220,167.235.145.223,216,2304889,97,7810,119,2297079,74.733638,0.164094,380757,111988445
141.101.96.233,167.235.145.223,6,427,2,132,4,295,2.241354,29.809923,35,79
141.101.96.240,167.235.145.223,7,493,3,198,4,295,20.90016,29.88741,52,78
141.101.96.242,167.235.145.223,6,427,2,132,4,295,4.235586,29.911566,35,78
141.101.96.252,167.235.145.223,6,427,2,132,4,295,9.010384,29.757115,35,79
141.101.96.253,167.235.145.223,199,1770394,91,7414,108,1762980,32.836122,30.188784,1964,467188
141.101.98.91,167.235.145.223,335,4724772,153,12196,182,4712576,18.649101,61.007317,1599,617968
141.101.98.95,167.235.145.223,7,493,3,198,4,295,13.199654,29.957773,52,78
141.101.98.103,167.235.145.223,6,427,2,132,4,295,1.040655,29.966421,35,78
141.101.98.106,167.235.145.223,42,26170,28,13202,14,12968,2.613275,78.044715,1353,1329
141.101.98.133,167.235.145.223,372,4956228,181,14044,191,4942184,12.616276,60.958104,1843,648600
141.101.98.151,167.235.145.223,328,4495296,149,11932,179,4483364,6.60684,60.875697,1568,589182
141.101.98.158,167.235.145.223,42,23538,28,10570,14,12968,1.70344,78.153496,1081,1327
141.101.98.188,167.235.145.223,6,427,2,132,4,295,25.328457,29.995622,35,78
141.101.98.214,167.235.145.223,42,26857,28,13888,14,12969,1.30123,78.097992,1422,1328
141.101.98.217,167.235.145.223,327,4242063,157,12460,170,4229603,36.651058,31.333415,3181,1079895
141.101.98.229,167.235.145.223,42,26324,28,13356,14,12968,0.550763,78.096708,1368,1328
141.101.98.234,167.235.145.223,317,4590968,139,11272,178,4579696,24.629538,31.216585,2888,1173657
141.101.99.14,167.235.145.223,302,4354891,130,10678,172,4344213,78.680734,1.89296,45127,18359449
141.101.99.18,167.235.145.223,323,4838427,140,11338,183,4827089,54.657437,1.534376,59114,25167698
141.101.99.30,167.235.145.223,7,493,3,198,4,295,7.135496,29.993744,52,78
141.101.99.109,167.235.145.223,352,5195924,163,12856,189,5183068,48.67047,31.472024,3267,1317504
141.101.99.118,167.235.145.223,377,4076625,169,13252,208,4063373,42.652519,31.469258,3368,1032975
141.101.99.138,167.235.145.223,42,24490,28,11522,14,12968,1.234057,78.107298,1180,1328
141.101.99.142,167.235.145.223,371,5963650,158,12966,213,5950684,72.674435,1.841383,56331,25853107
141.101.99.147,167.235.145.223,327,4314371,156,12394,171,4301977,60.654961,1.651685,60030,20836791
141.101.99.150,167.235.145.223,339,4881653,154,12262,185,4869391,66.663519,1.720346,57021,22643775
141.101.99.185,167.235.145.223,352,4972925,165,12988,187,4959937,30.697089,31.190856,3331,1272151
141.101.99.192,167.235.145.223,42,23034,28,10066,14,12968,1.278856,79.185618,1016,1310
141.101.99.196,167.235.145.223,320,4121080,152,12130,168,4108950,0.619022,60.788716,1596,540751
141.101.99.210,167.235.145.223,6,427,2,132,4,295,19.267824,29.967099,35,78
141.101.104.71,167.235.145.223,142,1239414,66,5874,76,1233540,23.693707,30.498677,1540,323565
141.101.104.73,167.235.145.223,127,1090771,60,5478,67,1085293,59.729628,0.10308,425145,84229181
141.101.104.74,167.235.145.223,141,4056077,73,6429,68,4049648,11.813006,59.905022,858,540809
141.101.104.84,167.235.145.223,295,5342958,132,10974,163,5331984,71.172647,0.5797,151443,73582666
141.101.104.87,167.235.145.223,153,1448069,71,6204,82,1441865,29.709606,30.219902,1642,381699
141.101.104.90,167.235.145.223,135,1166644,63,5676,72,1160968,35.703853,30.110536,1508,308454
141.101.104.104,167.235.145.223,72,3304236,16,2667,56,3301569,0.383036,77.338662,275,341518
141.101.104.106,167.235.145.223,6,427,2,132,4,295,30.192754,29.566355,35,79
141.101.104.114,167.235.145.223,90,57468,60,29679,30,27789,1.27096,81.831272,2901,2716
141.101.105.2,167.235.145.223,312,6126055,141,12435,171,6113620,53.168189,12.563371,7918,3892980
141.101.105.6,167.235.145.223,236,4350700,99,8796,137,4341904,77.195706,0.624035,112762,55662313
141.101.105.19,167.235.145.223,6,427,2,132,4,295,5.775297,29.945516,35,78
141.101.105.27,167.235.145.223,6,427,2,132,4,295,11.858701,29.964302,35,78
141.101.105.37,167.235.145.223,6,427,2,132,4,295,23.702635,29.971296,35,78
141.101.105.40,167.235.145.223,278,4877792,128,10710,150,4867082,65.143021,0.508854,168378,76518325
141.101.105.45,167.235.145.223,120,1231946,52,4950,68,1226996,77.712358,0.106864,370564,91854768
141.101.105.47,167.235.145.223,152,1457027,73,6336,79,1450691,71.727023,0.107467,471661,107991550
141.101.105.53,167.235.145.223,6,427,2,132,4,295,6.200551,29.533222,35,79
141.101.105.55,167.235.145.223,261,4491039,117,9984,144,4481055,5.137059,60.691865,1316,590663
141.101.105.57,167.235.145.223,151,1369584,73,6336,78,1363248,47.698177,30.370611,1668,359096
141.101.105.62,167.235.145.223,210,4352007,114,33958,96,4318049,1.300484,78.776171,3448,438513
141.101.105.64,167.235.145.223,255,156025,170,77238,85,78787,0.397977,79.634823,7759,7914
141.101.105.70,167.235.145.223,137,1395790,61,5544,76,1390246,53.702923,0.105687,419654,105234967
141.101.105.71,167.235.145.223,144,1242585,66,5874,78,1236711,5.699746,60.055224,782,164743
141.101.105.79,167.235.145.223,6,427,2,132,4,295,0.182641,29.538394,35,79
141.101.105.83,167.235.145.223,262,4587503,118,10050,144,4577453,23.11106,30.701749,2618,1192753
141.101.105.85,167.235.145.223,301,4951706,145,11832,156,4939874,11.11468,60.475214,1565,653474
141.101.105.89,167.235.145.223,155,1339741,75,6468,80,1333273,11.716287,60.046625,861,177631
141.101.105.104,167.235.145.223,6,427,2,132,4,295,17.867034,29.884089,35,78
141.101.105.124,167.235.145.223,252,4237277,116,9918,136,4227359,35.125624,30.464132,2604,1110120
141.101.105.130,167.235.145.223,135,1220875,63,5676,72,1215199,41.701261,30.105595,1508,322916
141.101.105.137,167.235.145.223,42,26786,28,13818,14,12968,3.236231,78.044458,1416,1329
141.101.105.138,167.235.145.223,42,26114,28,13146,14,12968,0.475577,78.066154,1347,1328
141.101.105.155,167.235.145.223,398,9673785,173,15291,225,9658494,17.101498,42.952856,2847,1798901
141.101.105.159,167.235.145.223,6,427,2,132,4,295,24.177883,29.567907,35,79
157.52.78.22,167.235.145.223,96,2526001,53,5588,43,2520413,5.126318,73.988413,604,272519
157.52.78.24,167.235.145.223,390,9161243,219,48918,171,9112325,0.821199,82.132134,4764,887577
157.52.78.25,167.235.145.223,493,13901952,264,28758,229,13873194,8.339552,74.766138,3077,1484436
157.52.78.26,167.235.145.223,444,12742258,238,26414,206,12715844,1.488364,63.704569,3317,1596851
157.52.78.27,167.235.145.223,138,3882334,74,9112,64,3873222,15.656559,36.416388,2001,850874
157.52.78.30,167.235.145.223,88,2543665,47,5336,41,2538329,38.746492,35.243258,1211,576184
157.52.78.32,167.235.145.223,911,24968123,513,56059,398,24912064,1.496862,75.671441,5926,2633708
157.52.78.33,167.235.145.223,423,9381361,239,61146,184,9320215,0.914153,82.152016,5954,907606
157.52.78.34,167.235.145.223,317,8937570,174,18687,143,8918883,17.845649,51.119802,2924,1395761
157.52.106.22,167.235.145.223,853,25501377,445,53448,408,25447929,0.261545,75.071937,5695,2711844
157.52.106.23,167.235.145.223,261,7665670,136,16611,125,7649059,0.587093,82.25565,1615,743930
157.52.106.24,167.235.145.223,361,10859421,187,22131,174,10837290,12.261527,70.306175,2518,1233153
157.52.106.26,167.235.145.223,600,12478238,295,29658,305,12448580,28.483798,29.017999,8176,3431960
157.52.106.27,167.235.145.223,573,12020593,280,28876,293,11991717,54.915182,26.131478,8840,3671194
157.52.106.29,167.235.145.223,102,2561929,56,12136,46,2549793,6.620042,69.222542,1402,294677
157.52.106.30,167.235.145.223,403,6821849,192,18776,211,6803073,47.664734,12.956253,11593,4200642
157.52.106.31,167.235.145.223,977,28861215,508,60533,469,28800682,1.508816,58.5719,8267,3933720
157.52.106.32,167.235.145.223,143,1310254,89,43089,54,1267165,0.175271,82.168515,4195,123372
157.52.106.33,167.235.145.223,340,10361027,176,20456,164,10340571,11.052856,41.656483,3928,1985874
157.52.106.34,167.235.145.223,273,8137791,143,17121,130,8120670,0.227019,33.234707,4121,1954744
157.52.106.35,167.235.145.223,415,3087019,222,50715,193,3036304,0.185313,82.578623,4913,294149
157.52.106.37,167.235.145.223,384,5812883,184,17155,200,5795728,71.666809,8.952969,15328,5178821
157.52.106.38,167.235.145.223,7,2205,4,1357,3,848,20.897699,60.031248,180,113
157.52.108.30,167.235.145.223,17,7810,9,2177,8,5633,64.97782,0.047393,367480,950857
162.158.18.6,167.235.145.223,426,4887501,205,15734,221,4871767,65.171279,2.581217,48764,15099131
162.158.18.32,167.235.145.223,416,4844696,205,15759,211,4828937,53.05533,2.721646,46321,14194166
162.158.18.42,167.235.145.223,333,2433266,155,11739,178,2421527,8.395112,60.131208,1561,322165
162.158.18.64,167.235.145.223,6,427,2,132,4,295,3.85266,29.77222,35,79
162.158.18.74,167.235.145.223,277,1242199,135,10319,142,1231880,79.574398,0.332128,248554,29672415
162.158.18.77,167.235.145.223,7,493,3,198,4,295,17.150826,29.770103,53,79
162.158.18.79,167.235.145.223,336,2483036,159,12744,177,2470292,7.538837,62.160774,1640,317922
162.158.18.84,167.235.145.223,6,427,2,132,4,295,1.7833,29.944433,35,78
162.158.18.87,167.235.145.223,474,5354713,240,18044,234,5336669,71.370601,2.38225,60594,17921440
162.158.18.91,167.235.145.223,349,2337861,170,12729,179,2325132,64.543232,0.368202,276565,50518617
162.158.18.93,167.235.145.223,346,2477473,163,12832,183,2464641,25.547237,41.885003,2450,470744
162.158.18.103,167.235.145.223,83,1332659,38,3173,45,1329486,0.55665,60.03852,422,177151
162.158.18.113,167.235.145.223,6,427,2,132,4,295,24.973553,29.876633,35,78
162.158.18.114,167.235.145.223,293,2437821,142,11446,151,2426375,43.550967,9.430464,9709,2058329
162.158.18.124,167.235.145.223,330,2603161,158,12678,172,2590483,67.648334,5.504401,18425,3764962
162.158.18.131,167.235.145.223,403,5047246,196,16044,207,5031202,13.544393,60.079594,2136,669938
162.158.18.138,167.235.145.223,873,532267,582,262459,291,269808,0.649075,82.288157,25516,26230
162.158.18.139,167.235.145.223,294,179389,196,88538,98,90851,0.591504,82.507642,8584,8808
162.158.18.153,167.235.145.223,313,1778017,155,11737,158,1766280,34.895647,30.34354,3094,465675
162.158.18.162,167.235.145.223,389,4159031,186,14626,203,4144405,50.378319,32.595508,3589,1017172
162.158.18.165,167.235.145.223,291,1405845,144,10913,147,1394932,55.549068,0.329939,264606,33822785
162.158.18.178,167.235.145.223,377,230148,252,114587,125,115561,0.636944,80.074905,11447,11545
162.158.18.179,167.235.145.223,561,342645,374,169423,187,173222,0.799933,80.864331,16761,17137
162.158.18.183,167.235.145.223,324,2140374,156,11805,168,2128569,15.363103,60.134335,1570,283175
162.158.18.186,167.235.145.223,334,2077750,163,12267,171,2065483,22.375251,60.148431,1631,274718
162.158.18.188,167.235.145.223,448,5202390,217,16551,231,5185839,47.05922,32.764813,4041,1266197
162.158.18.192,167.235.145.223,361,2400346,176,13866,185,2386480,1.532814,62.135426,1785,307261
162.158.18.195,167.235.145.223,6,427,2,132,4,295,25.836289,29.976307,35,78
162.158.18.200,167.235.145.223,6,427,2,132,4,295,23.122169,29.788328,35,79
162.158.18.205,167.235.145.223,428,4598427,213,16287,215,4582140,23.050646,32.732771,3980,1119890
162.158.18.210,167.235.145.223,12,854,4,264,8,590,1.846695,30.022592,70,157
162.158.19.52,167.235.145.223,311,2891183,147,11937,164,2879246,31.554056,41.499365,2301,555043
162.158.19.55,167.235.145.223,427,4977840,206,15659,221,4962181,28.351219,33.430388,3747,1187465
162.158.19.64,167.235.145.223,6,427,2,132,4,295,10.876388,29.709398,35,79
162.158.19.67,167.235.145.223,354,2395488,172,12859,182,2382629,23.33623,48.06463,2140,396570
162.158.19.77,167.235.145.223,546,339997,364,171248,182,168749,0.123539,81.933708,16720,16476
162.158.19.78,167.235.145.223,543,338004,362,170263,181,167741,0.29749,82.799908,16450,16206
162.158.19.79,167.235.145.223,287,1378451,141,10715,146,1367736,49.546031,30.376326,2821,360211
162.158.19.86,167.235.145.223,380,2788909,188,13915,192,2774994,28.884438,30.377367,3664,730805
162.158.19.89,167.235.145.223,397,4361316,189,14726,208,4346590,76.9141,2.841637,41457,12236862
162.158.19.95,167.235.145.223,383,4245724,186,14339,197,4231385,34.278864,33.677284,3406,1005160
162.158.19.107,167.235.145.223,162,4372970,82,7669,80,4365301,1.432353,81.663559,751,427637
162.158.19.120,167.235.145.223,347,2313634,168,12595,179,2301039,77.021962,0.398273,252992,46220336
162.158.19.122,167.235.145.223,489,6811068,243,19851,246,6791217,5.057071,68.071806,2332,798123
162.158.19.123,167.235.145.223,361,2133761,184,13653,177,2120108,36.68274,30.395871,3593,557998
162.158.19.133,167.235.145.223,6,427,2,132,4,295,18.176034,29.744586,35,79
162.158.19.140,167.235.145.223,6,427,2,132,4,295,7.848279,29.934123,35,78
162.158.19.141,167.235.145.223,385,4077284,190,14769,195,4062515,41.055771,32.736086,3609,992791
162.158.19.143,167.235.145.223,651,387819,434,186716,217,201103,0.310319,82.315023,18146,19544
162.158.19.144,167.235.145.223,216,125650,144,59258,72,66392,0.396501,81.812032,5794,6492
162.158.19.146,167.235.145.223,502,7468886,245,20009,257,7448877,10.04661,71.76073,2230,830412
162.158.19.149,167.235.145.223,424,4320904,216,16485,208,4304419,59.062732,2.688654,49050,12807654
162.158.19.154,167.235.145.223,337,2092986,160,12069,177,2080917,57.406524,0.388929,248250,42803020
162.158.19.157,167.235.145.223,6,427,2,132,4,295,18.373076,29.908714,35,78
162.158.19.170,167.235.145.223,6,427,2,132,4,295,19.814511,29.955559,35,78
162.158.19.171,167.235.145.223,406,4729600,185,14450,221,4715150,15.891794,63.871331,1809,590581
162.158.19.173,167.235.145.223,293,2178845,145,11820,148,2167025,61.551587,11.399075,8295,1520842
162.158.22.7,167.235.145.223,258,2681374,115,9081,143,2672293,73.923009,0.214728,338325,99560113
162.158.22.32,167.235.145.223,263,2494888,123,9609,140,2485279,31.85233,30.342935,2533,655250
162.158.22.46,167.235.145.223,247,2605332,104,8355,143,2596977,49.859734,30.354258,2201,684444
162.158.22.106,167.235.145.223,233,2164456,105,8421,128,2156035,61.857109,0.25121,268174,68660801
162.158.22.113,167.235.145.223,306,4560308,139,11505,167,4548803,37.855019,30.078925,3059,1209831
162.158.22.116,167.235.145.223,254,2304472,120,9411,134,2295061,25.845456,30.216537,2491,607630
162.158.22.138,167.235.145.223,228,2067728,104,8355,124,2059373,1.835443,60.083678,1112,274200
162.158.22.142,167.235.145.223,6,427,2,132,4,295,20.182644,29.677428,35,79
162.158.22.146,167.235.145.223,250,2256024,115,9081,135,2246943,7.784283,60.08224,1209,299182
162.158.22.161,167.235.145.223,42,26310,28,13342,14,12968,1.710932,78.07803,1367,1328
162.158.22.164,167.235.145.223,256,2370927,117,9213,139,2361714,19.788576,60.08451,1226,314452
162.158.22.167,167.235.145.223,233,2185542,106,8487,127,2177055,79.872206,0.216063,314241,80608155
162.158.22.179,167.235.145.223,6,427,2,132,4,295,14.006157,29.858756,35,79
162.158.22.196,167.235.145.223,6,427,2,132,4,295,26.00693,29.868915,35,79
162.158.22.221,167.235.145.223,251,2427805,111,8817,140,2418988,55.853151,0.270685,260583,71492339
162.158.23.32,167.235.145.223,6,427,2,132,4,295,8.041261,29.770535,35,79
162.158.23.46,167.235.145.223,225,2043405,101,8157,124,2035248,43.892625,30.515694,2138,533560
162.158.23.53,167.235.145.223,6,427,2,132,4,295,2.158775,29.68796,35,79
162.158.23.59,167.235.145.223,272,2486490,127,9873,145,2476617,13.791502,60.086176,1314,329742
162.158.33.132,167.235.145.223,369,2501793,165,12289,204,2489504,32.429526,30.458898,3227,653865
162.158.33.133,167.235.145.223,362,2501332,169,12554,193,2488778,32.051761,30.444794,3298,653977
162.158.33.135,167.235.145.223,18,7551,11,3646,7,3905,7.317287,66.210361,440,471
162.158.33.157,167.235.145.223,335,4495808,151,12114,184,4483694,8.028572,60.387353,1604,593991
162.158.33.161,167.235.145.223,342,4954298,155,12378,187,4941920,14.00203,60.393455,1639,654629
162.158.60.131,167.235.145.223,319,2311752,151,11439,168,2300313,74.524696,0.338517,270332,54362126
162.158.60.139,167.235.145.223,145,4384797,74,6528,71,4378269,2.516417,54.046684,966,648072
162.158.60.140,167.235.145.223,361,2395885,187,13815,174,2382070,68.521008,0.386853,285689,49260468
162.158.60.143,167.235.145.223,327,2131481,159,11967,168,2119514,38.573483,30.432353,3145,557173
162.158.60.144,167.235.145.223,204,6285525,103,9264,101,6276261,8.559433,54.396969,1362,923030
162.158.60.147,167.235.145.223,120,4368078,51,5010,69,4363068,20.522908,42.037836,953,830312
162.158.60.148,167.235.145.223,92,2326963,42,14836,50,2312127,2.448713,78.115451,1519,236790
162.158.60.150,167.235.145.223,158,4973288,77,6726,81,4966562,8.905926,72.172291,745,550522
162.158.62.14,167.235.145.223,7,493,3,198,4,295,14.587629,29.408298,53,80
162.158.62.52,167.235.145.223,651,2520496,322,22743,329,2497753,31.642614,30.91833,5884,646284
162.158.62.55,167.235.145.223,7,493,3,198,4,295,8.615904,29.366244,53,80
162.158.62.59,167.235.145.223,618,2280311,296,21027,322,2259284,7.6375,60.336982,2787,299555
162.158.62.106,167.235.145.223,42,26310,28,13342,14,12968,1.533499,78.097509,1366,1328
162.158.62.151,167.235.145.223,568,2090168,264,18915,304,2071253,1.639384,60.347195,2507,274578
162.158.62.159,167.235.145.223,592,2326780,276,19707,316,2307073,25.642052,30.957882,5092,596183
162.158.62.171,167.235.145.223,608,2210292,297,21093,311,2189199,79.656521,0.917412,183934,19090214
162.158.62.172,167.235.145.223,605,2628960,278,19839,327,2609121,49.653927,30.916939,5133,675130
162.158.62.178,167.235.145.223,636,2396006,305,21621,331,2374385,19.642077,60.346712,2866,314765
162.158.62.188,167.235.145.223,659,2707840,317,22413,342,2685427,73.667576,0.92402,194047,23249946
162.158.62.198,167.235.145.223,7,493,3,198,4,295,26.594517,29.404634,53,80
162.158.62.215,167.235.145.223,587,2067297,282,20103,305,2047194,43.661269,30.983092,5190,528596
162.158.62.243,167.235.145.223,6,427,2,132,4,295,2.586977,29.398389,35,80
162.158.63.59,167.235.145.223,607,2152987,298,21159,309,2131828,37.653942,30.944166,5470,551141
162.158.63.78,167.235.145.223,7,493,3,198,4,295,20.589271,29.399402,53,80
162.158.63.80,167.235.145.223,660,2454798,330,23271,330,2431527,55.65664,0.90942,204710,21389694
162.158.63.96,167.235.145.223,644,2511042,312,22083,332,2488959,13.650328,60.34114,2927,329985
162.158.63.109,167.235.145.223,605,2189009,285,20301,320,2168708,61.649687,0.948548,171217,18290760
162.158.63.115,167.235.145.223,641,2474630,311,22017,330,2452613,67.649853,0.916714,192138,21403517
162.158.74.21,167.235.145.223,6,427,2,132,4,295,26.406532,29.992814,35,78
162.158.74.24,167.235.145.223,363,2435106,164,12224,199,2422882,56.035352,0.438295,223119,44223767
162.158.74.25,167.235.145.223,280,2429626,133,10177,147,2419449,56.390658,0.243202,334766,79586483
162.158.74.26,167.235.145.223,6,427,2,132,4,295,20.52175,29.696271,35,79
162.158.74.27,167.235.145.223,6,427,2,132,4,295,20.62358,29.828861,35,79
162.158.74.35,167.235.145.223,45,26716,30,12821,15,13895,1.944658,78.058549,1313,1424
162.158.74.37,167.235.145.223,296,2132370,111,8726,185,2123644,38.081385,30.47957,2290,557394
162.158.74.47,167.235.145.223,664,4908289,314,23523,350,4884766,68.062088,0.609587,308707,64105907
162.158.74.62,167.235.145.223,7,493,3,198,4,295,2.422282,29.975251,52,78
162.158.74.73,167.235.145.223,341,4725217,154,12312,187,4712905,20.009156,60.399676,1630,624229
162.158.74.108,167.235.145.223,6,427,2,132,4,295,4.455734,29.866314,35,79
162.158.74.116,167.235.145.223,423,2056382,199,14534,224,2041848,44.045394,30.47461,3815,536012
162.158.74.117,167.235.145.223,255,2045293,120,9319,135,2035974,44.402154,30.307244,2459,537422
162.158.86.12,167.235.145.223,185,2327082,87,7265,98,2319817,4.498851,60.030836,968,309150
162.158.86.18,167.235.145.223,90,57364,60,29572,30,27792,1.164103,81.927499,2887,2713
162.158.86.23,167.235.145.223,159,2352606,95,27512,64,2325094,0.084805,82.490545,2668,225489
162.158.86.27,167.235.145.223,87,55247,58,28384,29,26863,0.120635,79.562484,2854,2701
162.158.86.40,167.235.145.223,336,4653284,162,14517,174,4638767,8.055328,70.119604,1656,529240
162.158.86.47,167.235.145.223,6,427,2,132,4,295,16.364068,29.9595,35,78
162.158.86.62,167.235.145.223,115,1231625,56,5223,59,1226402,77.203526,0.051704,808138,189757388
162.158.86.65,167.235.145.223,265,5190381,122,10350,143,5180031,48.110182,10.65093,7773,3890763
162.158.86.66,167.235.145.223,126,80307,84,41398,42,38909,0.231119,79.725782,4154,3904
162.158.86.68,167.235.145.223,6,427,2,132,4,295,4.532993,29.960669,35,78
162.158.86.73,167.235.145.223,7,493,3,198,4,295,4.951285,29.817302,53,79
162.158.86.77,167.235.145.223,129,82448,86,42544,43,39904,0.449908,79.283854,4292,4026
162.158.86.80,167.235.145.223,213,4234749,92,8379,121,4226370,34.964929,41.6112,1610,812544
162.158.86.94,167.235.145.223,259,4876574,123,10416,136,4866158,66.121312,10.299093,8090,3779873
162.158.86.107,167.235.145.223,198,2424370,96,7859,102,2416511,10.514275,60.03221,1047,322028
162.158.86.109,167.235.145.223,6,427,2,132,4,295,2.46285,29.602619,35,79
162.158.86.113,167.235.145.223,77,2454816,37,4098,40,2450718,22.623727,33.917211,966,578047
162.158.86.128,167.235.145.223,178,2326589,83,7001,95,2319588,64.542517,0.058966,949835,314701760
162.158.86.143,167.235.145.223,42,24734,28,11760,14,12974,3.268599,78.043046,1205,1329
162.158.86.146,167.235.145.223,132,1455716,67,5949,65,1449767,74.022661,0.052932,899115,219113881
162.158.86.155,167.235.145.223,73,2118687,36,3248,37,2115439,16.503124,60.010437,432,282009
162.158.86.171,167.235.145.223,209,2777639,101,8189,108,2769450,28.508157,30.318796,2160,730754
162.158.86.172,167.235.145.223,73,2508843,29,3570,44,2505273,16.635225,63.451264,450,315867
162.158.86.182,167.235.145.223,81,2376788,38,4164,43,2372624,2.061784,62.785926,530,302312
162.158.86.191,167.235.145.223,229,4308104,105,9228,124,4298876,60.203258,10.368105,7120,3317000
162.158.86.203,167.235.145.223,130,4103451,60,5453,70,4097998,0.153493,70.512076,618,464941
162.158.86.211,167.235.145.223,6,427,2,132,4,295,23.476725,29.968843,35,78
162.158.86.221,167.235.145.223,69,44045,46,22742,23,21303,2.711101,77.83594,2337,2189
162.158.86.222,167.235.145.223,42,26718,28,13748,14,12970,1.558477,78.048925,1409,1329
162.158.86.226,167.235.145.223,15,3899,8,1684,7,2215,6.822738,71.212,189,248
162.158.86.244,167.235.145.223,6,427,2,132,4,295,22.553545,29.969966,35,78
162.158.86.250,167.235.145.223,48,29380,32,14557,16,14823,1.528297,78.033351,1492,1519
162.158.87.4,167.235.145.223,6,427,2,132,4,295,2.519902,29.975642,35,78
162.158.87.17,167.235.145.223,6,427,2,132,4,295,28.64313,29.744691,35,79
162.158.87.19,167.235.145.223,154,2465971,90,27449,64,2438522,1.977356,80.766107,2718,241539
162.158.87.25,167.235.145.223,6,427,2,132,4,295,22.73127,29.784448,35,79
162.158.87.37,167.235.145.223,190,2303288,98,7991,92,2295297,76.563431,0.059344,1077244,309422620
162.158.87.60,167.235.145.223,166,2220343,77,6605,89,2213738,52.523526,30.19343,1750,586548
162.158.87.64,167.235.145.223,49,1330627,24,2460,25,1328167,1.559122,60.008368,327,177064
162.158.87.105,167.235.145.223,93,58741,62,30026,31,28715,0.010447,78.9379,3042,2910
162.158.87.110,167.235.145.223,7,493,3,198,4,295,16.703966,29.809571,53,79
162.158.87.119,167.235.145.223,116,4476370,41,4353,75,4472017,6.093349,70.453281,494,507799
162.158.87.134,167.235.145.223,261,4722885,123,10416,138,4712469,72.118156,10.716014,7776,3518076
162.158.87.145,167.235.145.223,6,427,2,132,4,295,17.509884,29.947587,35,78
162.158.87.148,167.235.145.223,119,1301173,59,5413,60,1295760,71.188556,0.05173,837115,200388169
162.158.87.156,167.235.145.223,6,427,2,132,4,295,10.842475,29.716189,35,79
162.158.87.157,167.235.145.223,169,2066874,79,6737,90,2060137,22.508812,60.030018,897,274547
162.158.87.160,167.235.145.223,160,2664182,74,7036,86,2657146,12.284421,61.776596,911,344097
162.158.87.171,167.235.145.223,87,55044,58,28172,29,26872,2.563048,79.914831,2820,2690
162.158.87.173,167.235.145.223,68,2401510,26,2496,42,2399014,4.76386,60.009875,332,319815
162.158.87.181,167.235.145.223,249,4719276,117,10029,132,4709247,16.769849,42.465291,1889,887171
162.158.87.183,167.235.145.223,183,2384187,89,7397,94,2376790,70.553414,0.05921,999425,321133592
162.158.87.185,167.235.145.223,256,4587151,125,10557,131,4576594,22.564482,42.44619,1989,862568
162.158.87.190,167.235.145.223,144,1766879,67,5945,77,1760934,34.512624,30.382994,1565,463663
162.158.87.198,167.235.145.223,301,7074583,129,11693,172,7062890,28.557372,42.115617,2221,1341619
162.158.87.202,167.235.145.223,309,7017870,140,12419,169,7005451,10.992862,47.550016,2089,1178624
162.158.87.209,167.235.145.223,243,4833397,108,9475,135,4823922,53.761473,10.86758,6974,3551055
162.158.87.212,167.235.145.223,170,2881948,81,7653,89,2874295,28.611111,33.530875,1825,685766
162.158.87.219,167.235.145.223,216,4066200,93,8436,123,4057764,42.09944,40.534587,1664,800849
162.158.87.232,167.235.145.223,192,2384781,96,7859,96,2376922,46.531314,30.420388,2066,625086
162.158.87.235,167.235.145.223,153,2320352,75,7257,78,2313095,34.624467,33.46466,1734,552964
162.158.94.7,167.235.145.223,6,427,2,132,4,295,2.517823,29.766197,35,79
162.158.94.10,167.235.145.223,119,1243945,58,5349,61,1238596,19.719036,60.024862,712,165077
162.158.94.12,167.235.145.223,124,1325637,60,5481,64,1320156,1.714384,60.025188,730,175946
162.158.94.20,167.235.145.223,6,427,2,132,4,295,29.455992,29.992942,35,78
162.158.94.28,167.235.145.223,342,4885297,200,69151,142,4816146,0.223741,79.991041,6915,481668
162.158.94.29,167.235.145.223,262,1822799,166,66528,96,1756271,0.700908,80.971805,6572,173519
162.158.94.30,167.235.145.223,6,427,2,132,4,295,3.73936,29.880702,35,78
162.158.94.39,167.235.145.223,166,2120921,79,6753,87,2114168,38.184553,30.052834,1797,562786
162.158.94.40,167.235.145.223,189,116579,126,58133,63,58446,0.36803,80.089408,5806,5838
162.158.94.41,167.235.145.223,375,230784,250,114832,125,115952,0.525795,80.859162,11361,11471
162.158.94.48,167.235.145.223,6,427,2,132,4,295,9.532097,29.975415,35,78
162.158.94.59,167.235.145.223,247,4755045,115,9646,132,4745399,44.27657,35.839432,2153,1059257
162.158.94.61,167.235.145.223,7,493,3,198,4,295,26.199851,29.545484,53,79
162.158.94.67,167.235.145.223,510,321620,340,164127,170,157493,0.298783,82.692399,15878,15236
162.158.94.79,167.235.145.223,44,1212744,22,2322,22,1210422,20.383214,59.903163,310,161650
162.158.94.81,167.235.145.223,162,2778843,75,7126,87,2771717,53.012062,0.745845,76434,29729683
162.158.94.82,167.235.145.223,112,1198275,55,5151,57,1193124,55.735739,0.050987,808206,187204424
162.158.94.84,167.235.145.223,174,106658,116,52930,58,53728,0.125238,81.382056,5203,5281
162.158.94.85,167.235.145.223,171,103463,114,50662,57,52801,1.395032,80.077027,5061,5275
162.158.94.86,167.235.145.223,132,1937860,52,4952,80,1932908,82.32163,0.067804,584272,228058285
162.158.94.94,167.235.145.223,202,6336681,101,9167,101,6327514,27.711946,37.888425,1935,1336031
162.158.94.108,167.235.145.223,6,427,2,132,4,295,14.317559,29.972208,35,78
162.158.94.118,167.235.145.223,429,262338,286,129781,143,132557,0.581123,81.359726,12761,13034
162.158.94.119,167.235.145.223,213,133181,142,67412,71,65769,0.770264,80.75032,6678,6515
162.158.94.140,167.235.145.223,186,2314861,96,7664,90,2307197,81.484113,0.058389,1050060,316113925
162.158.94.154,167.235.145.223,118,1367409,55,5151,63,1362258,43.718727,30.25167,1362,360246
162.158.94.156,167.235.145.223,349,3698527,210,81195,139,3617332,0.516784,82.208991,7901,352013
162.158.94.157,167.235.145.223,364,1393317,225,83947,139,1309370,0.424297,81.812499,8208,128036
162.158.94.164,167.235.145.223,110,1168036,52,4953,58,1163083,13.719188,60.025669,660,155011
162.158.94.181,167.235.145.223,6,427,2,132,4,295,2.109249,29.635188,35,79
162.158.94.193,167.235.145.223,312,196037,208,99921,104,96116,0.564632,82.285979,9714,9344
162.158.94.199,167.235.145.223,308,7243920,137,12360,171,7231560,52.989185,0.718476,137624,80521103
162.158.94.206,167.235.145.223,268,6517741,112,10394,156,6507347,76.256505,0.88234,94240,59000811
162.158.94.213,167.235.145.223,107,1357661,42,4293,65,1353368,7.73655,60.022792,572,180380
162.158.94.217,167.235.145.223,321,8003943,136,12138,185,7991805,71.084423,0.672293,144437,95099071
162.158.94.226,167.235.145.223,276,6093741,125,11551,151,6082190,40.981827,30.777491,3002,1580944
162.158.94.228,167.235.145.223,339,209547,226,104730,113,104817,0.559602,80.718523,10379,10388
162.158.94.229,167.235.145.223,342,211606,228,105928,114,105678,0.13589,81.241665,10430,10406
162.158.94.241,167.235.145.223,119,1506075,52,4953,67,1501122,25.75542,30.251448,1309,396971
162.158.94.247,167.235.145.223,111,1309679,51,4887,60,1304792,61.744227,0.047472,823559,219884057
162.158.94.251,167.235.145.223,44,1188546,20,2054,24,1186492,3.541027,60.008702,273,158175
162.158.95.5,167.235.145.223,159,2899193,71,6915,88,2892278,71.489007,0.255098,216857,90703274
162.158.95.13,167.235.145.223,537,331911,358,165958,179,165953,0.090597,80.47687,16497,16496
162.158.95.17,167.235.145.223,153,1767489,75,6489,78,1761000,31.191809,30.151489,1721,467240
162.158.95.22,167.235.145.223,322,7047251,150,13009,172,7034242,65.119661,0.603325,172497,93273005
162.158.95.27,167.235.145.223,6,427,2,132,4,295,15.756481,29.635069,35,79
162.158.95.29,167.235.145.223,189,116345,126,57911,63,58434,0.793385,79.832251,5803,5855
162.158.95.30,167.235.145.223,189,116764,126,58333,63,58431,1.123324,80.12764,5824,5833
162.158.95.33,167.235.145.223,199,2776995,91,7545,108,2769450,25.125186,30.05684,2008,737123
162.158.95.38,167.235.145.223,304,6873015,141,12576,163,6860439,22.787897,30.670864,3280,1789434
162.158.95.48,167.235.145.223,479,2314143,309,134982,170,2179161,0.450455,81.247672,13290,214569
162.158.95.49,167.235.145.223,139,2451934,63,6387,76,2445547,77.472922,0.238324,214397,82091505
162.158.95.56,167.235.145.223,155,2477146,77,7311,78,2469835,65.505729,0.216929,269618,91083626
162.158.95.63,167.235.145.223,488,2387121,304,120670,184,2266451,0.152734,81.979179,11775,221173
162.158.95.64,167.235.145.223,180,114373,120,58952,60,55421,1.077704,81.059932,5818,5469
162.158.95.76,167.235.145.223,6,427,2,132,4,295,14.194197,29.553338,35,79
162.158.95.85,167.235.145.223,322,7416268,143,12345,179,7403923,10.354887,60.521678,1631,978680
162.158.95.93,167.235.145.223,93,58726,62,30008,31,28718,1.421729,78.250073,3067,2936
162.158.95.94,167.235.145.223,93,59069,62,30347,31,28722,0.03105,79.543113,3052,2888
162.158.95.98,167.235.145.223,119,1304191,59,5415,60,1298776,67.725557,0.047471,912557,218874849
162.158.95.107,167.235.145.223,6,427,2,132,4,295,7.914277,29.821142,35,79
162.158.95.110,167.235.145.223,222,4774558,109,11073,113,4763485,23.351905,41.767259,2120,912386
162.158.95.115,167.235.145.223,583,360799,389,181019,194,179780,0.002262,83.022809,17442,17323
162.158.95.118,167.235.145.223,182,2131023,92,7602,90,2123421,14.270432,60.026318,1013,282998
162.158.95.126,167.235.145.223,84,2871006,36,3901,48,2867105,1.865201,58.177163,536,394258
162.158.95.130,167.235.145.223,158,2220815,68,6039,90,2214776,48.779577,30.419264,1588,582466
162.158.95.134,167.235.145.223,166,2325812,71,6225,95,2319587,62.185789,0.073624,676409,252046832
162.158.95.135,167.235.145.223,174,2520593,89,8128,85,2512465,17.003566,60.735978,1070,330935
162.158.95.140,167.235.145.223,172,2665076,86,7930,86,2657146,11.006615,60.711874,1044,350131
162.158.95.143,167.235.145.223,171,2725176,86,7852,85,2717324,46.99198,30.79659,2039,705876
162.158.95.156,167.235.145.223,348,7939350,154,13797,194,7925553,47.006615,30.708633,3594,2064710
162.158.95.168,167.235.145.223,110,1282512,52,4953,58,1277559,73.744979,0.050769,780476,201313242
162.158.95.169,167.235.145.223,372,233799,248,118854,124,114945,0.717916,81.514635,11664,11280
162.158.95.170,167.235.145.223,368,232235,245,118296,123,113939,0.772328,80.988518,11685,11254
162.158.95.171,167.235.145.223,6,427,2,132,4,295,20.311206,29.975207,35,78
162.158.95.176,167.235.145.223,192,3323425,86,8085,106,3315340,55.234008,27.622269,2341,960193
162.158.95.178,167.235.145.223,6,427,2,132,4,295,23.475071,29.97034,35,78
162.158.95.180,167.235.145.223,6,427,2,132,4,295,20.006587,29.742791,35,79
162.158.95.184,167.235.145.223,375,9317279,167,15865,208,9301414,4.89676,71.406984,1777,1042073
162.158.95.190,167.235.145.223,98,995437,46,4557,52,990880,31.715484,30.174015,1208,262710
162.158.95.191,167.235.145.223,195,119022,130,58967,65,60055,0.840498,81.472876,5790,5896
162.158.95.192,167.235.145.223,192,116777,128,57440,64,59337,1.052579,81.057009,5669,5856
162.158.95.195,167.235.145.223,347,7074480,167,14011,180,7060469,15.916748,60.411712,1855,934980
162.158.95.199,167.235.145.223,283,4757783,145,11988,138,4745795,68.223377,0.084961,1128800,446868092
162.158.95.205,167.235.145.223,6,427,2,132,4,295,20.584408,29.992393,35,78
162.158.95.211,167.235.145.223,311,6457634,144,12818,167,6444816,58.883158,0.865638,118460,59561303
162.158.95.218,167.235.145.223,92,2599285,41,3833,51,2595452,8.243637,60.008829,510,346009
162.158.95.220,167.235.145.223,6,427,2,132,4,295,8.390439,29.618196,35,79
162.158.95.223,167.235.145.223,6,427,2,132,4,295,14.056548,29.969911,35,78
162.158.95.226,167.235.145.223,179,2302569,87,7272,92,2295297,74.289346,0.055398,1050146,331462796
162.158.102.48,167.235.145.223,271,2187898,114,8864,157,2179034,79.40369,0.314201,225689,55481274
162.158.102.52,167.235.145.223,294,2071933,136,10316,158,2061617,1.353254,60.122019,1372,274324
162.158.102.73,167.235.145.223,306,2497576,143,10778,163,2486798,31.391695,30.325901,2843,656019
162.158.102.119,167.235.145.223,339,2490761,166,12296,173,2478465,13.355879,60.124277,1636,329778
162.158.102.124,167.235.145.223,324,2308940,155,11570,169,2297370,25.356166,30.327695,3051,606012
162.158.102.171,167.235.145.223,323,2134092,151,11306,172,2122786,37.360593,30.373635,2977,559112
162.158.102.187,167.235.145.223,6,427,2,132,4,295,1.712905,29.801271,35,79
162.158.102.230,167.235.145.223,317,2453095,155,11570,162,2441525,67.398745,0.314756,294069,62055052
162.158.103.5,167.235.145.223,303,2373878,141,10646,162,2363232,19.400505,60.118759,1416,314475
162.158.103.7,167.235.145.223,6,427,2,132,4,295,13.709729,29.800166,35,79
162.158.103.16,167.235.145.223,42,24197,28,11228,14,12969,1.257048,78.081376,1150,1328
162.158.103.88,167.235.145.223,302,2168860,147,11042,155,2157818,61.360115,0.306955,287781,56238028
162.158.103.125,167.235.145.223,316,2260229,153,11438,163,2248791,7.389151,60.120601,1522,299237
162.158.103.128,167.235.145.223,290,2047544,129,9854,161,2037690,43.396905,30.406538,2592,536118
162.158.103.196,167.235.145.223,359,2612573,174,12824,185,2599749,49.353504,30.464061,3367,682705
162.158.110.5,167.235.145.223,480,302810,320,154426,160,148384,0.017181,82.641425,14949,14364
162.158.110.7,167.235.145.223,237,4832979,100,8896,137,4824083,7.043326,64.365,1105,599590
162.158.110.29,167.235.145.223,6,427,2,132,4,295,6.661198,29.936194,35,78
162.158.110.32,167.235.145.223,165,2664612,78,7395,87,2657217,10.703268,61.887308,955,343491
162.158.110.34,167.235.145.223,147,2476594,68,6784,79,2469810,23.741126,30.890756,1756,639624
162.158.110.50,167.235.145.223,41,1188336,17,1844,24,1186492,0.585967,60.00789,245,158178
162.158.110.52,167.235.145.223,6,427,2,132,4,295,11.363402,29.905959,35,78
162.158.110.55,167.235.145.223,305,7306616,131,11603,174,7295013,65.101871,1.037499,89469,56250756
162.158.110.58,167.235.145.223,231,4247990,106,9294,125,4238696,13.738206,63.628318,1168,532932
162.158.110.60,167.235.145.223,304,7243254,132,11628,172,7231626,53.059603,1.050036,88591,55096213
162.158.110.68,167.235.145.223,187,2384467,92,7611,95,2376856,67.128101,0.096207,632885,197645160
162.158.110.80,167.235.145.223,153,93980,102,46738,51,47242,0.168088,80.119261,4666,4717
162.158.110.81,167.235.145.223,150,91971,100,45653,50,46318,0.207254,79.593202,4588,4655
162.158.110.84,167.235.145.223,318,6873436,152,12798,166,6860638,22.919341,30.775017,3326,1783430
162.158.110.99,167.235.145.223,847,7486455,529,202483,318,7283972,1.029889,82.027239,19747,710395
162.158.110.100,167.235.145.223,159,2249681,66,5510,93,2244171,5.46924,60.028234,734,299082
162.158.110.101,167.235.145.223,224,4489963,93,8364,131,4481599,4.919268,60.547065,1105,592147
162.158.110.111,167.235.145.223,14,986,6,396,8,590,23.315779,30.027081,105,157
162.158.110.114,167.235.145.223,157,2609837,77,7378,80,2602459,63.28843,4.452758,13255,4675680
162.158.110.123,167.235.145.223,134,1981551,67,6718,67,1974833,33.181892,37.169586,1445,425042
162.158.110.125,167.235.145.223,152,2470889,71,6932,81,2463957,5.240429,61.310939,904,321503
162.158.110.128,167.235.145.223,258,4641506,125,10546,133,4630960,0.538849,64.863621,1300,571162
162.158.110.129,167.235.145.223,246,4616619,117,10077,129,4606542,80.455668,2.383594,33821,15460827
162.158.110.137,167.235.145.223,6,427,2,132,4,295,11.44871,29.953806,35,78
162.158.110.152,167.235.145.223,510,311322,340,153824,170,157498,0.166484,81.210744,15153,15514
162.158.110.155,167.235.145.223,110,1140807,56,5149,54,1135658,82.542991,0.051956,792824,174864577
162.158.110.159,167.235.145.223,143,2434159,68,6784,75,2427375,51.203892,7.017915,7733,2767061
162.158.110.169,167.235.145.223,704,432693,470,215851,234,216842,0.909918,82.16672,21015,21112
162.158.110.179,167.235.145.223,238,4592014,109,9534,129,4582480,73.132943,9.051453,8426,4050160
162.158.110.187,167.235.145.223,474,300002,316,153638,158,146364,1.246469,81.806119,15024,14313
162.158.110.194,167.235.145.223,235,4350451,113,9537,122,4340914,76.332947,2.244458,33993,15472471
162.158.110.195,167.235.145.223,166,2180978,79,6563,87,2174415,76.356573,0.057404,914640,303033238
162.158.110.196,167.235.145.223,294,6456114,141,12222,153,6443892,59.055979,1.106985,88326,46568956
162.158.110.204,167.235.145.223,145,2325860,68,6784,77,2319076,19.291586,61.757929,878,300408
162.158.110.207,167.235.145.223,313,7072151,140,12144,173,7060007,16.731349,60.735271,1599,929938
162.158.110.214,167.235.145.223,209,3866590,99,8561,110,3858029,82.403921,0.641572,106750,48107199
162.158.110.225,167.235.145.223,276,5877400,142,14313,134,5863087,7.634358,52.796177,2168,888410
162.158.110.227,167.235.145.223,156,2555600,73,7114,83,2548486,0.586859,65.019201,875,313567
162.158.110.229,167.235.145.223,6,427,2,132,4,295,29.559062,29.953755,35,78
162.158.110.233,167.235.145.223,187,3521914,85,7963,102,3513951,31.086192,34.316701,1856,819181
162.158.110.236,167.235.145.223,489,304336,326,153352,163,150984,0.154584,80.024304,15330,15093
162.158.110.246,167.235.145.223,216,4623495,105,10833,111,4612662,23.206456,38.599753,2245,955998
162.158.110.249,167.235.145.223,171,2725309,86,7984,85,2717325,47.606802,32.253202,1980,673998
162.158.110.252,167.235.145.223,393,244755,262,123638,131,121117,0.522568,82.42956,11999,11754
162.158.110.253,167.235.145.223,393,244872,262,123508,131,121364,0.209248,82.1707,12024,11815
162.158.111.2,167.235.145.223,276,4983288,130,11077,146,4972211,43.124247,34.379463,2577,1157018
162.158.111.3,167.235.145.223,168,2707024,81,7642,87,2699382,13.049212,64.89917,942,332747
162.158.111.17,167.235.145.223,243,152280,162,77100,81,75180,0.171386,81.916517,7529,7342
162.158.111.18,167.235.145.223,243,152913,162,77805,81,75108,0.005338,81.608062,7627,7362
162.158.111.25,167.235.145.223,164,6333788,63,6273,101,6327515,24.837018,40.960094,1225,1235839
162.158.111.30,167.235.145.223,6,427,2,132,4,295,29.473567,29.992801,35,78
162.158.111.33,167.235.145.223,186,119553,124,61966,62,57587,1.399205,80.036002,6193,5756
162.158.111.34,167.235.145.223,183,117409,122,60891,61,56518,1.4155,79.191897,6151,5709
162.158.111.44,167.235.145.223,38,1248417,13,1611,25,1246806,4.275121,60.008451,214,166217
162.158.111.45,167.235.145.223,125,1455251,62,5616,63,1449635,71.687691,0.053914,833327,215103312
162.158.111.46,167.235.145.223,125,1455180,61,5479,64,1449701,71.639618,0.051333,853875,225928895
162.158.111.49,167.235.145.223,315,7377485,141,12011,174,7365474,28.923847,30.894078,3110,1907284
162.158.111.67,167.235.145.223,232,4151650,114,9877,118,4141773,55.132455,4.509678,17521,7347350
162.158.111.76,167.235.145.223,333,7778542,150,12816,183,7765726,47.038712,31.119361,3294,1996371
162.158.111.77,167.235.145.223,152,2555353,72,7096,80,2548257,74.364174,3.923615,14468,5195733
162.158.111.87,167.235.145.223,236,5076877,117,11675,119,5065202,65.631664,16.873407,5535,2401507
162.158.111.94,167.235.145.223,322,7416066,143,12143,179,7403923,10.922039,60.615339,1602,977168
162.158.111.96,167.235.145.223,158,2519474,76,7208,82,2512266,16.715317,61.868224,932,324853
162.158.111.102,167.235.145.223,225,4428446,102,9085,123,4419361,49.100947,4.395935,16533,8042632
162.158.111.103,167.235.145.223,126,79274,84,40286,42,38988,1.049185,81.867381,3936,3809
162.158.111.104,167.235.145.223,129,81134,86,41212,43,39922,0.35747,82.695656,3986,3862
162.158.111.105,167.235.145.223,38,1284835,14,1912,24,1282923,9.627201,60.008722,254,171031
162.158.111.108,167.235.145.223,138,2319301,60,6206,78,2313095,35.307251,31.298148,1586,591241
162.158.111.113,167.235.145.223,286,6094078,135,11887,151,6082191,41.042246,30.861787,3081,1576627
162.158.111.123,167.235.145.223,459,285905,306,144108,153,141797,0.485265,79.327123,14533,14299
162.158.111.129,167.235.145.223,148,2386303,72,7048,76,2379255,57.247418,6.805535,8285,2796846
162.158.111.130,167.235.145.223,8,559,4,264,4,295,17.397726,29.865568,70,79
162.158.111.140,167.235.145.223,6,427,2,132,4,295,5.411333,29.931064,35,78
162.158.111.143,167.235.145.223,170,2725231,86,7972,84,2717259,45.167622,8.027893,7944,2707817
162.158.111.147,167.235.145.223,49,1312426,24,2337,25,1310089,2.117888,60.007846,311,174655
162.158.111.158,167.235.145.223,474,295154,316,148710,158,146444,0.368277,82.096939,14491,14270
162.158.111.167,167.235.145.223,420,1458165,274,121157,146,1337008,0.562342,81.601959,11877,131076
162.158.111.168,167.235.145.223,422,1460809,275,122871,147,1337938,0.227092,82.631657,11895,129532
162.158.111.175,167.235.145.223,6,427,2,132,4,295,17.365296,29.971105,35,78
162.158.111.181,167.235.145.223,822,518858,548,264955,274,253903,0.068454,81.681677,25950,24867
162.158.111.188,167.235.145.223,232,4230033,108,9481,124,4220552,37.104681,34.32235,2209,983744
162.158.111.193,167.235.145.223,251,4641070,122,10405,129,4630665,61.117969,4.316884,19282,8581495
162.158.111.202,167.235.145.223,148,2597211,67,6718,81,2590493,69.330177,4.748925,11317,4363923
162.158.111.218,167.235.145.223,88,2527839,46,4681,42,2523158,11.482036,65.088051,575,310122
162.158.111.219,167.235.145.223,12,854,4,264,8,590,4.971606,30.194536,69,156
162.158.111.226,167.235.145.223,286,5411068,134,11197,152,5399871,25.102701,34.762759,2576,1242679
162.158.111.237,167.235.145.223,345,211747,230,105207,115,106540,0.497305,81.779747,10291,10422
162.158.111.238,167.235.145.223,348,215766,232,108223,116,107543,0.360771,82.427551,10503,10437
162.158.129.2,167.235.145.223,975,600907,650,299563,325,301344,0.384755,82.171057,29164,29338
162.158.129.3,167.235.145.223,486,300612,324,150530,162,150082,0.64529,80.916155,14882,14838
162.158.129.8,167.235.145.223,192,1173394,87,7209,105,1166185,16.736717,60.095407,959,155244
162.158.129.13,167.235.145.223,462,9660267,199,17373,263,9642894,52.162663,3.680358,37763,20960773
162.158.129.14,167.235.145.223,259,4166980,115,10755,144,4156225,53.297131,4.901477,17553,6783628
162.158.129.29,167.235.145.223,486,10372939,213,18218,273,10354721,47.096935,32.780754,4446,2527024
162.158.129.45,167.235.145.223,615,8626890,282,23530,333,8603360,57.853477,3.971105,47402,17331921
162.158.129.54,167.235.145.223,349,6640698,153,13139,196,6627559,49.294956,4.430926,23722,11966002
162.158.129.59,167.235.145.223,191,1227528,86,7143,105,1220385,52.777623,0.230852,247535,42291511
162.158.129.60,167.235.145.223,173,1256478,68,5955,105,1250523,82.822754,0.225808,210975,44303939
162.158.129.75,167.235.145.223,49,1234137,25,2466,24,1231671,7.873445,74.922419,263,131514
162.158.129.76,167.235.145.223,82,1191118,41,3504,41,1187614,0.060667,60.024034,467,158285
162.158.129.82,167.235.145.223,269,2320513,122,9523,147,2310990,24.24368,56.575249,1346,326784
162.158.129.84,167.235.145.223,1432,3486513,943,423138,489,3063375,0.008546,83.088397,40740,294950
162.158.129.85,167.235.145.223,540,336154,360,169470,180,166684,0.09285,82.743653,16385,16115
162.158.129.99,167.235.145.223,461,9431188,214,18275,247,9412913,15.80781,63.989197,2284,1176812
162.158.129.100,167.235.145.223,444,9164681,198,17032,246,9147649,22.820122,33.034722,4124,2215281
162.158.129.103,167.235.145.223,652,19525978,257,24276,395,19501702,4.730785,57.420718,3382,2717026
162.158.129.104,167.235.145.223,2049,1265679,1366,632527,683,633152,0.120634,82.762487,61141,61201
162.158.129.111,167.235.145.223,6,427,2,132,4,295,28.195821,29.938576,35,78
162.158.129.112,167.235.145.223,6,427,2,132,4,295,17.779357,29.914288,35,78
162.158.129.116,167.235.145.223,375,6958823,169,14211,206,6944612,0.827198,64.868953,1752,856448
162.158.129.121,167.235.145.223,6,427,2,132,4,295,6.102343,29.959156,35,78
162.158.129.122,167.235.145.223,444,8465676,209,17885,235,8447791,34.086033,33.728983,4242,2003687
162.158.129.126,167.235.145.223,420,7185907,195,15911,225,7169996,7.305391,64.411299,1976,890526
162.158.129.128,167.235.145.223,517,7145087,230,18872,287,7126215,67.352297,4.581819,32951,12442595
162.158.129.131,167.235.145.223,7,493,3,198,4,295,23.183393,29.660268,53,79
162.158.129.133,167.235.145.223,6,427,2,132,4,295,29.763115,29.937856,35,78
162.158.129.146,167.235.145.223,46,1348446,20,2136,26,1346310,10.743833,60.024098,284,179435
162.158.129.153,167.235.145.223,284,4546699,136,12957,148,4533742,59.246806,11.603529,8933,3125767
162.158.129.164,167.235.145.223,293,4322892,141,12471,152,4310421,29.265202,41.29956,2415,834957
162.158.129.166,167.235.145.223,591,363016,394,180439,197,182577,0.748765,82.226013,17555,17763
162.158.129.167,167.235.145.223,903,553970,602,275130,301,278840,0.224435,82.597246,26647,27007
162.158.129.169,167.235.145.223,429,11474819,166,16537,263,11458282,4.787333,73.290321,1805,1250727
162.158.129.170,167.235.145.223,232,3884931,103,9963,129,3874968,65.294834,5.438812,14654,5699727
162.158.129.174,167.235.145.223,1275,6921752,745,294068,530,6627684,0.787934,82.077522,28662,645992
162.158.129.175,167.235.145.223,909,567524,606,286588,303,280936,0.423137,82.435431,27812,27263
162.158.129.179,167.235.145.223,381,6380247,166,14153,215,6366094,19.308083,34.689944,3263,1468112
162.158.129.183,167.235.145.223,387,3651078,157,13527,230,3637551,41.490209,35.529689,3045,819044
162.158.129.184,167.235.145.223,173,1202247,77,6549,96,1195698,58.795136,0.165233,317079,57891486
162.158.129.188,167.235.145.223,1251,4389268,762,278805,489,4110463,0.295063,82.361448,27081,399260
162.158.129.189,167.235.145.223,1266,781984,844,390612,422,391372,0.079157,82.963452,37665,37739
162.158.129.216,167.235.145.223,6,427,2,132,4,295,28.887725,29.921426,35,78
162.158.129.220,167.235.145.223,6,427,2,132,4,295,6.137964,29.534806,35,79
162.158.129.229,167.235.145.223,603,6241574,234,18485,369,6223089,55.310041,4.483247,32985,11104610
162.158.129.231,167.235.145.223,194,4107869,49,4922,145,4102947,0.096631,61.706666,638,531929
162.158.129.241,167.235.145.223,2261,1397555,1507,699027,754,698528,0.062239,83.040375,67343,67295
162.158.129.253,167.235.145.223,554,7142393,249,19475,305,7122918,43.342287,34.466101,4520,1653315
162.158.130.6,167.235.145.223,282,3743515,118,10881,164,3732634,23.286176,53.5363,1625,557772
162.158.130.10,167.235.145.223,391,4094301,143,12603,248,4081698,47.26544,34.208668,2947,954541
162.158.130.11,167.235.145.223,259,2279231,113,9892,146,2269339,82.653957,0.379606,208468,47825145
162.158.130.13,167.235.145.223,201,1315565,93,7605,108,1307960,64.813649,0.201736,301582,51868184
162.158.130.17,167.235.145.223,844,9919504,375,29393,469,9890111,10.785245,63.029088,3730,1255307
162.158.130.28,167.235.145.223,189,5830997,91,9336,98,5821661,1.860062,71.65193,1042,649993
162.158.130.30,167.235.145.223,540,8701025,196,17083,344,8683942,76.170437,3.71777,36759,18686345
162.158.130.33,167.235.145.223,385,8795345,166,14972,219,8780373,5.037448,66.737396,1794,1052528
162.158.130.36,167.235.145.223,249,1376001,118,9255,131,1366746,46.78876,30.287882,2444,361001
162.158.130.46,167.235.145.223,524,12224949,203,18678,321,12206271,30.934285,34.892394,4282,2798609
162.158.130.47,167.235.145.223,707,9129381,255,21780,452,9107601,34.754811,39.187407,4446,1859291
162.158.130.51,167.235.145.223,579,351901,386,173018,193,178883,0.452757,81.30952,17023,17600
162.158.130.52,167.235.145.223,1154,701430,769,344441,385,356989,0.056104,83.035805,33184,34393
162.158.130.55,167.235.145.223,327,3484425,147,12867,180,3471558,35.249742,39.185336,2626,708746
162.158.130.60,167.235.145.223,6,427,2,132,4,295,26.125526,29.671539,35,79
162.158.130.61,167.235.145.223,13,920,5,330,8,590,10.054038,31.638381,83,149
162.158.130.65,167.235.145.223,39,1263584,16,1872,23,1261712,19.867182,51.264077,292,196896
162.158.130.67,167.235.145.223,6,427,2,132,4,295,12.173955,29.945267,35,78
162.158.130.68,167.235.145.223,6,427,2,132,4,295,15.752304,29.50444,35,79
162.158.130.70,167.235.145.223,6,427,2,132,4,295,22.067502,29.820541,35,79
162.158.130.71,167.235.145.223,773,9769993,333,26590,440,9743403,65.186793,2.672985,79581,29161115
162.158.130.72,167.235.145.223,6,427,2,132,4,295,1.675658,29.965472,35,78
162.158.130.73,167.235.145.223,404,6888411,184,15185,220,6873226,73.328668,4.44002,27360,12384135
162.158.130.76,167.235.145.223,896,10706393,376,29624,520,10676769,70.270926,3.629801,65290,23531359
162.158.162.18,167.235.145.223,643,1402051,278,19861,365,1382190,49.259197,31.647737,5020,349393
162.158.162.56,167.235.145.223,6,427,2,132,4,295,27.16679,28.921275,36,81
162.158.162.57,167.235.145.223,706,1493586,338,23821,368,1469765,73.275802,1.552333,122762,7574483
162.158.162.63,167.235.145.223,692,1483638,305,21643,387,1461995,31.730346,31.762903,5451,368227
162.158.162.119,167.235.145.223,6,427,2,132,4,295,5.290306,28.949496,36,81
162.158.162.170,167.235.145.223,620,1123304,296,21049,324,1102255,61.241354,1.640972,102617,5373668
162.158.162.173,167.235.145.223,638,1275184,299,21247,339,1253937,7.290315,60.631564,2803,165450
162.158.163.32,167.235.145.223,6,427,2,132,4,295,8.9627,28.966246,36,81
162.158.163.79,167.235.145.223,680,1338201,312,22105,368,1316096,67.425381,1.74556,101308,6031742
162.158.163.108,167.235.145.223,893,2229124,411,28639,482,2200485,80.576236,1.918688,119410,9174957
162.158.163.121,167.235.145.223,587,1368247,247,17815,340,1350432,13.415917,60.630702,2350,178184
162.158.163.127,167.235.145.223,679,1274851,321,22699,358,1252152,25.310008,31.810209,5708,314905
162.158.163.131,167.235.145.223,6,427,2,132,4,295,2.451683,28.940945,36,81
162.158.163.153,167.235.145.223,649,1254794,298,21181,351,1233613,43.365436,31.72436,5341,311082
162.158.163.187,167.235.145.223,180,1263942,78,6010,102,1257932,14.874673,64.552301,744,155896
162.158.163.191,167.235.145.223,45,28521,30,14625,15,13896,1.016211,79.443716,1472,1399
162.158.163.217,167.235.145.223,829,2660342,360,26135,469,2634207,55.249139,24.265307,8616,868468
162.158.163.222,167.235.145.223,660,1234465,315,22303,345,1212162,1.25418,60.642784,2942,159908
162.158.163.233,167.235.145.223,6,427,2,132,4,295,0.118206,29.050466,36,81
162.158.163.243,167.235.145.223,2,132,1,66,1,66,0.091731,8.00E-06,,
162.158.178.37,167.235.145.223,6,427,2,132,4,295,17.107918,28.86264,36,81
162.158.178.62,167.235.145.223,627,1123574,289,20395,338,1103179,63.329234,1.91473,85213,4609230
162.158.178.78,167.235.145.223,656,1402717,306,21517,350,1381200,51.261677,1.90388,90413,5803727
162.158.178.94,167.235.145.223,7,493,3,198,4,295,23.245361,28.804421,54,81
162.158.178.95,167.235.145.223,619,1427405,249,17755,370,1409650,57.331689,1.896336,74902,5946836
162.158.178.111,167.235.145.223,7,493,3,198,4,295,29.180681,28.791906,55,81
162.158.178.125,167.235.145.223,615,1252358,246,17557,369,1234801,45.212452,31.936849,4397,309310
162.158.178.180,167.235.145.223,712,1376306,316,22177,396,1354129,15.203089,60.767777,2919,178269
162.158.178.186,167.235.145.223,6,427,2,132,4,295,5.151067,28.849006,36,81
162.158.178.227,167.235.145.223,653,1200635,290,20461,363,1180174,39.296627,32.004386,5114,295003
162.158.178.234,167.235.145.223,597,1332531,240,17161,357,1315370,69.318303,2.143709,64042,4908763
162.158.178.251,167.235.145.223,669,1267983,293,20659,376,1247324,81.205494,1.727048,95696,5777831
162.158.179.34,167.235.145.223,625,1271095,268,19009,357,1252086,27.180629,31.864022,4772,314357
162.158.179.37,167.235.145.223,721,1280470,332,23233,389,1257237,9.171432,60.830971,3055,165341
162.158.179.51,167.235.145.223,706,1237310,336,23497,370,1213813,3.260695,60.81838,3090,159663
162.158.179.80,167.235.145.223,42,23933,28,10962,14,12971,2.693256,78.231445,1120,1326
162.158.179.113,167.235.145.223,665,1300896,298,20989,367,1279907,21.26903,60.743829,2764,168564
162.158.179.126,167.235.145.223,6,427,2,132,4,295,11.023079,28.8984,36,81
162.158.179.149,167.235.145.223,676,1491414,277,19603,399,1471811,75.209521,1.840394,85212,6397808
162.158.186.21,167.235.145.223,39,24245,26,12194,13,12051,5.127591,72.241994,1350,1334
162.158.186.30,167.235.145.223,6,427,2,132,4,295,13.136983,28.827749,36,81
162.158.186.46,167.235.145.223,918,2375382,443,30714,475,2344668,65.39623,1.797713,136680,10434003
162.158.186.70,167.235.145.223,810,2109102,360,25236,450,2083866,23.332017,31.780301,6352,524567
162.158.186.97,167.235.145.223,6,427,2,132,4,295,29.6488,29.832604,35,79
162.158.186.103,167.235.145.223,874,2429746,401,27942,473,2401804,47.376254,31.741408,7042,605342
162.158.186.119,167.235.145.223,901,2823264,408,28404,493,2794860,29.342024,31.809412,7143,702901
162.158.186.123,167.235.145.223,6,427,2,132,4,295,7.111851,28.839744,36,81
162.158.186.128,167.235.145.223,928,2376073,443,30714,485,2345359,5.322932,60.644352,4051,309391
162.158.186.146,167.235.145.223,754,1807092,337,23718,417,1783374,35.355655,31.621946,6000,451173
162.158.186.188,167.235.145.223,929,2472569,446,30912,483,2441657,11.330004,60.63921,4078,322122
162.158.186.210,167.235.145.223,886,2267816,421,29262,465,2238554,53.391399,1.732329,135133,10337777
162.158.186.228,167.235.145.223,896,2178093,423,29394,473,2148699,17.351801,60.66429,3876,283356
162.158.186.236,167.235.145.223,854,2166266,393,27414,461,2138852,41.364659,31.844475,6886,537324
162.158.186.240,167.235.145.223,7,493,3,198,4,295,19.178444,28.822264,54,81
162.158.186.245,167.235.145.223,6,427,2,132,4,295,25.102342,28.843212,36,81
162.158.187.18,167.235.145.223,801,2123577,378,26424,423,2097153,59.378163,1.910561,110643,8781307
162.158.187.40,167.235.145.223,889,2349375,428,29724,461,2319651,77.4039,1.723094,138002,10769701
162.158.187.57,167.235.145.223,6,427,2,132,4,295,1.111248,28.848305,36,81
162.158.187.82,167.235.145.223,918,2432650,429,29790,489,2402860,71.401804,1.802221,132236,10666216
162.158.202.5,167.235.145.223,223,2043404,117,9343,106,2034061,41.80352,30.149255,2479,539731
162.158.202.15,167.235.145.223,246,2448689,129,10135,117,2438554,65.657674,0.136546,593792,142870768
162.158.202.16,167.235.145.223,242,2255626,117,9343,125,2246283,5.64799,60.071906,1244,299145
162.158.202.25,167.235.145.223,220,2302358,106,8617,114,2293741,23.637975,30.141841,2287,608785
162.158.202.49,167.235.145.223,237,2128697,125,9871,112,2118826,35.667735,30.406978,2597,557457
162.158.202.62,167.235.145.223,6,427,2,132,4,295,30.104849,29.595972,35,79
162.158.202.73,167.235.145.223,250,2494161,121,9607,129,2484554,29.647347,30.356465,2531,654767
162.158.202.93,167.235.145.223,228,2164257,109,8815,119,2155442,59.667106,0.207956,339110,82919155
162.158.202.96,167.235.145.223,82,2354437,39,3544,43,2350893,11.860854,65.811707,430,285772
162.158.202.118,167.235.145.223,6,427,2,132,4,295,23.819069,29.88892,35,78
162.158.202.143,167.235.145.223,258,2606188,133,10399,125,2595789,47.641668,30.217221,2753,687234
162.158.203.40,167.235.145.223,7,493,3,198,4,295,6.140323,29.557547,53,79
162.158.203.62,167.235.145.223,249,2680910,124,9805,125,2671105,71.679549,0.145399,539481,146966897
162.158.203.84,167.235.145.223,244,2427473,126,9937,118,2417536,53.662115,0.138865,572469,139274028
162.158.203.88,167.235.145.223,6,427,2,132,4,295,17.936979,29.803139,35,79
162.158.203.91,167.235.145.223,6,427,2,132,4,295,0.077572,29.617252,35,79
162.158.203.118,167.235.145.223,39,26122,26,14079,13,12043,5.500535,72.023422,1563,1337
162.158.203.127,167.235.145.223,285,2487478,154,11785,131,2475693,11.654905,60.066304,1569,329728
162.158.203.138,167.235.145.223,234,2185738,117,9343,117,2176395,77.657261,0.165273,452245,105347878
162.158.222.19,167.235.145.223,315,2335635,152,11559,163,2324076,63.380532,0.307237,300979,60515523
162.158.222.23,167.235.145.223,310,2784309,148,11295,162,2773014,27.742758,30.368207,2975,730504
162.158.222.24,167.235.145.223,373,4745633,170,13623,203,4732010,3.382032,66.001221,1651,573566
162.158.222.28,167.235.145.223,6,427,2,132,4,295,21.696652,29.685848,35,79
162.158.222.41,167.235.145.223,402,4247318,204,15866,198,4231452,12.40773,51.325459,2473,659548
162.158.222.46,167.235.145.223,344,4068775,170,13691,174,4055084,65.52644,6.773132,16170,4789611
162.158.222.63,167.235.145.223,312,2190826,157,11923,155,2178903,78.238436,0.308481,309205,56506637
162.158.222.71,167.235.145.223,399,4870877,194,15206,205,4855671,30.421572,45.060443,2699,862072
162.158.222.77,167.235.145.223,310,2308203,148,11294,162,2296909,24.437201,30.311859,2980,606207
162.158.222.83,167.235.145.223,313,2139666,154,11691,159,2127975,15.366352,60.119792,1555,283164
162.158.222.86,167.235.145.223,319,2453448,156,11857,163,2441591,66.21863,0.308027,307947,63412389
162.158.222.90,167.235.145.223,84,52285,56,26348,28,25937,0.541334,78.170608,2696,2654
162.158.222.102,167.235.145.223,7,493,3,198,4,295,6.711769,29.814208,53,79
162.158.222.103,167.235.145.223,297,2129555,143,10965,154,2118590,39.37895,30.309823,2894,559182
162.158.222.107,167.235.145.223,369,3311041,195,15307,174,3295734,51.3699,14.691938,8334,1794580
162.158.222.110,167.235.145.223,409,4901676,203,15800,206,4885876,48.418353,26.980088,4684,1448735
162.158.222.124,167.235.145.223,330,2324595,166,12483,164,2312112,15.672592,66.01301,1512,280200
162.158.222.130,167.235.145.223,6,427,2,132,4,295,18.711736,29.81234,35,79
162.158.222.145,167.235.145.223,296,2090298,143,10965,153,2079333,57.375292,0.302309,290166,55025368
162.158.222.146,167.235.145.223,84,53624,56,27678,28,25946,0.35449,80.988061,2734,2562
162.158.222.149,167.235.145.223,6,427,2,132,4,295,24.707663,29.81351,35,79
162.158.222.152,167.235.145.223,137,4381396,66,6106,71,4375290,18.412087,54.314782,899,644434
162.158.222.163,167.235.145.223,294,2072119,145,11096,149,2061023,0.411603,60.121604,1476,274247
162.158.222.184,167.235.145.223,6,427,2,132,4,295,9.66532,29.807847,35,79
162.158.222.196,167.235.145.223,316,2393000,156,11823,160,2381177,3.669056,66.059912,1431,288365
162.158.222.199,167.235.145.223,99,62600,66,31956,33,30644,1.586661,79.675477,3208,3076
162.158.222.208,167.235.145.223,311,2076250,155,11757,156,2064493,21.362784,60.121503,1564,274709
162.158.222.213,167.235.145.223,6,427,2,132,4,295,27.662904,29.811259,35,79
162.158.222.218,167.235.145.223,292,2168386,139,10700,153,2157686,60.43257,0.346225,247238,49856272
162.158.222.239,167.235.145.223,84,49708,56,23758,28,25950,2.026677,80.468733,2361,2579
162.158.222.246,167.235.145.223,327,2432856,161,12152,166,2420704,54.423711,0.30813,315503,62848901
162.158.222.248,167.235.145.223,291,2258765,132,10238,159,2248527,6.411777,60.119283,1362,299208
162.158.223.7,167.235.145.223,6,427,2,132,4,295,0.709076,29.813299,35,79
162.158.223.10,167.235.145.223,316,2133816,160,12086,156,2121730,36.424423,30.452724,3175,557383
162.243.134.28,167.235.145.223,2,204,1,88,1,116,57.638425,3.40E-05,,
165.154.24.48,167.235.145.223,26,4644,12,2050,14,2594,72.696421,3.903874,4200,5315
167.235.145.223,43.249.73.27,4,333,2,201,2,132,22.510482,0.210293,7646,5021
167.235.145.223,43.249.73.29,4,333,2,201,2,132,9.19554,0.219043,7341,4820
167.235.145.223,43.249.73.37,4,333,2,201,2,132,1.010379,0.207996,7730,5077
167.235.145.223,43.249.74.26,4,333,2,201,2,132,53.220435,0.216583,7424,4875
167.235.145.223,43.249.74.27,4,333,2,201,2,132,8.837592,0.225305,7136,4686
167.235.145.223,43.249.74.34,4,333,2,201,2,132,22.751527,0.223272,7201,4729
167.235.145.223,43.249.74.40,4,333,2,201,2,132,15.775537,0.220995,7276,4778
167.235.145.223,43.249.74.41,4,333,2,201,2,132,41.298772,0.224101,7175,4712
167.235.145.223,43.249.74.46,4,333,2,201,2,132,28.676505,0.223636,7190,4721
167.235.145.223,43.249.74.59,4,333,2,201,2,132,2.757457,0.216764,7418,4871
167.235.145.223,43.249.74.70,4,333,2,201,2,132,47.359391,0.219964,7310,4800
167.235.145.223,85.73.250.195,1233,173617,772,131820,461,41797,0.003087,82.75064,12743,4040
167.235.145.223,104.156.92.36,201,2613595,96,2603968,105,9627,32.200647,24.031575,866848,3204
167.235.145.223,104.156.92.37,4,333,2,201,2,132,56.202437,0.012356,130139,85464
167.235.145.223,104.156.92.48,4,333,2,201,2,132,50.259522,0.015512,103661,68076
167.235.145.223,104.156.92.49,150,1315616,74,1308964,76,6652,38.271524,21.912793,477881,2428
167.235.145.223,104.156.92.62,154,1204170,75,1197320,79,6850,8.260743,47.646412,201034,1150
167.235.145.223,104.156.92.76,4,333,2,201,2,132,44.275375,0.01905,84409,55433
167.235.145.223,104.156.92.77,4,333,2,201,2,132,26.276442,0.019063,84351,55395
167.235.145.223,108.162.220.83,4,295,3,229,1,66,25.972594,0.011964,153126,44132
167.235.145.223,108.162.220.84,4,295,3,229,1,66,25.774497,0.01228,149185,42996
167.235.145.223,108.162.220.97,5,361,3,229,2,132,20.018325,0.012401,147730,85154
167.235.145.223,108.162.220.114,987,7351926,565,7320850,422,31076,6.523425,61.953326,945337,4012
167.235.145.223,108.162.220.115,4,295,3,229,1,66,4.825539,0.012063,151869,43770
167.235.145.223,108.162.221.11,4,295,3,229,1,66,13.737398,0.012074,151730,43730
167.235.145.223,108.162.221.17,4,295,3,229,1,66,7.742364,0.012134,150980,43514
167.235.145.223,108.162.221.41,4,295,3,229,1,66,19.76534,0.011921,153678,44291
167.235.145.223,108.162.221.45,5,361,3,229,2,132,0.461469,0.011883,154169,88866
167.235.145.223,108.162.221.56,342,2093144,185,2081476,157,11668,0.282402,55.6075,299452,1678
167.235.145.223,108.162.221.58,4,295,3,229,1,66,24.676511,0.012066,151831,43759
167.235.145.223,108.162.221.77,4,295,3,229,1,66,21.26945,0.01211,151279,43600
167.235.145.223,108.162.221.172,4,295,3,229,1,66,9.290407,0.020539,89196,25707
167.235.145.223,108.162.241.8,4,295,3,229,1,66,25.869452,0.100908,18155,5232
167.235.145.223,108.162.241.79,4,295,3,229,1,66,4.463466,0.111336,16454,4742
167.235.145.223,108.162.241.181,5,361,3,229,2,132,19.884638,0.111232,16470,9493
167.235.145.223,108.162.241.187,4,295,3,229,1,66,7.850351,0.101297,18085,5212
167.235.145.223,108.162.241.190,4,295,3,229,1,66,10.43565,0.101192,18104,5217
167.235.145.223,108.162.242.28,688,2194509,364,2171642,324,22867,13.875597,48.99642,354579,3733
167.235.145.223,108.162.242.42,4,295,3,229,1,66,28.494921,0.113896,16084,4635
167.235.145.223,108.162.242.65,4,295,3,229,1,66,1.871427,0.110494,16580,4778
167.235.145.223,140.248.69.23,4,333,2,201,2,132,32.131558,0.021298,75500,49582
167.235.145.223,140.248.69.25,200,1228299,104,1220359,96,7940,1.626392,42.510278,229659,1494
167.235.145.223,140.248.69.30,4,333,2,201,2,132,13.971541,0.020984,76629,50324
167.235.145.223,140.248.69.47,4,333,2,201,2,132,37.967364,0.021101,76204,50045
167.235.145.223,140.248.69.49,4,333,2,201,2,132,44.005437,0.018815,85463,56125
167.235.145.223,140.248.69.51,4,333,2,201,2,132,25.62246,0.021193,75874,49827
167.235.145.223,140.248.69.59,257,2686751,131,2675738,126,11013,7.866437,24.14262,886643,3649
167.235.145.223,140.248.74.42,4,333,2,201,2,132,33.916486,0.003765,,
167.235.145.223,140.248.74.45,4,333,2,201,2,132,1.438871,0.003776,,
167.235.145.223,140.248.74.60,4,333,2,201,2,132,30.181189,0.003671,,
167.235.145.223,140.248.74.67,4,333,2,201,2,132,28.715515,0.003733,,
167.235.145.223,140.248.74.72,4,333,2,201,2,132,58.708797,0.0037,,
167.235.145.223,140.248.74.77,4,333,2,201,2,132,46.61348,0.003719,,
167.235.145.223,140.248.74.79,4,333,2,201,2,132,40.776467,0.003719,,
167.235.145.223,140.248.74.81,4,333,2,201,2,132,37.103406,0.003689,,
167.235.145.223,140.248.74.95,4,333,2,201,2,132,20.741468,0.00374,,
167.235.145.223,140.248.74.105,167,1205440,43,1195208,124,10232,10.651471,48.182098,198448,1698
167.235.145.223,140.248.74.114,4,333,2,201,2,132,59.732466,0.003667,,
167.235.145.223,140.248.74.124,4,333,2,201,2,132,52.806444,0.003626,,
167.235.145.223,140.248.75.27,4,333,2,201,2,132,22.768497,0.003379,,
167.235.145.223,140.248.75.36,4,333,2,201,2,132,28.593522,0.003389,,
167.235.145.223,140.248.75.40,4,333,2,201,2,132,46.547494,0.003446,,
167.235.145.223,140.248.75.42,4,333,2,201,2,132,4.630506,0.003418,,
167.235.145.223,140.248.75.77,4,333,2,201,2,132,44.673396,0.003409,,
167.235.145.223,140.248.75.104,272,6816195,136,6798849,136,17346,10.998408,61.545474,883749,2254
167.235.145.223,140.248.83.21,4,333,2,201,2,132,31.09644,0.021313,75446,49547
167.235.145.223,140.248.83.43,4,333,2,201,2,132,48.86755,0.021371,75242,49412
167.235.145.223,140.248.83.44,4,333,2,201,2,132,52.93248,0.021425,75052,49288
167.235.145.223,140.248.83.53,4,333,2,201,2,132,42.875493,0.020831,77192,50693
167.235.145.223,140.248.83.54,4,333,2,201,2,132,36.844531,0.01867,86127,56561
167.235.145.223,140.248.83.57,190,1097743,99,1090133,91,7610,25.657483,33.288084,261987,1828
167.235.145.223,140.248.83.59,4,333,2,201,2,132,1.328505,0.021214,75799,49778
167.235.145.223,140.248.83.60,4,333,2,201,2,132,6.014633,0.018915,85011,55828
167.235.145.223,140.248.83.66,190,1454205,99,1446595,91,7610,18.173623,11.449088,1010801,5317
167.235.145.223,140.248.83.74,4,333,2,201,2,132,10.344511,0.018966,84783,55678
167.235.145.223,141.101.76.22,5,361,3,229,2,132,25.288541,0.009771,187493,108074
167.235.145.223,141.101.76.28,4,295,3,229,1,66,20.244409,0.009997,183254,52815
167.235.145.223,141.101.76.45,4,295,3,229,1,66,13.533396,0.009367,195580,56368
167.235.145.223,141.101.76.65,4,295,3,229,1,66,1.483389,0.009945,184213,53092
167.235.145.223,141.101.76.142,198,2132099,108,2124640,90,7459,10.617562,65.919538,257846,905
167.235.145.223,141.101.76.172,4,295,3,229,1,66,13.330423,0.009944,184231,53097
167.235.145.223,141.101.76.177,4,295,3,229,1,66,2.205371,0.009678,189295,54556
167.235.145.223,141.101.76.199,302,6696113,161,6683133,141,12980,7.288715,61.115145,874825,1699
167.235.145.223,141.101.76.207,5,361,3,229,2,132,14.212479,0.009417,194541,112137
167.235.145.223,141.101.77.27,227,3593943,115,3584170,112,9773,26.215444,44.399586,645802,1760
167.235.145.223,141.101.77.51,4,295,3,229,1,66,1.26137,0.009498,192882,55590
167.235.145.223,141.101.77.53,4,295,3,229,1,66,19.50844,0.009504,192760,55555
167.235.145.223,141.101.96.56,4,295,3,229,1,66,4.638957,0.015878,115379,33253
167.235.145.223,141.101.96.58,4,295,3,229,1,66,28.720007,0.014178,129214,37240
167.235.145.223,141.101.96.75,4,295,3,229,1,66,16.699542,0.018088,101282,29190
167.235.145.223,141.101.96.117,4,295,3,229,1,66,10.687667,0.012821,142890,41182
167.235.145.223,141.101.96.218,4,295,3,229,1,66,22.714481,0.014771,124026,35745
167.235.145.223,141.101.98.76,4,295,3,229,1,66,6.729378,0.020109,91103,26256
167.235.145.223,141.101.98.77,4,295,3,229,1,66,6.631366,0.020137,90976,26220
167.235.145.223,141.101.98.120,4,295,3,229,1,66,12.648321,0.021845,83863,24170
167.235.145.223,141.101.98.121,4,295,3,229,1,66,12.868333,0.020083,91221,26290
167.235.145.223,141.101.98.169,4,295,3,229,1,66,24.908464,0.021709,84388,24321
167.235.145.223,141.101.98.205,8,590,6,458,2,132,18.651476,0.260829,14047,4048
167.235.145.223,141.101.99.87,8,590,6,458,2,132,0.658523,0.023076,158779,45761
167.235.145.223,141.101.104.80,4,295,3,229,1,66,12.250476,0.009501,192821,55573
167.235.145.223,141.101.104.85,4,295,3,229,1,66,17.698435,0.009604,190753,54977
167.235.145.223,141.101.104.91,5,361,3,229,2,132,5.685143,0.009333,196292,113146
167.235.145.223,141.101.104.111,5,361,3,229,2,132,29.658907,0.009652,189805,109407
167.235.145.223,141.101.104.121,4,295,3,229,1,66,11.917402,0.009323,196503,56634
167.235.145.223,141.101.105.98,294,5192290,162,5181316,132,10974,24.137969,53.630141,772896,1636
167.235.145.223,141.101.105.113,4,295,3,229,1,66,23.70248,0.009583,191171,55097
167.235.145.223,141.101.105.141,4,295,3,229,1,66,5.841587,0.009326,196440,56615
167.235.145.223,157.52.78.20,341,1524570,177,1512110,164,12460,13.491624,13.480432,897365,7394
167.235.145.223,157.52.78.23,4,333,2,201,2,132,1.84152,0.044602,36052,23676
167.235.145.223,157.52.78.28,378,3823071,185,3806655,193,16416,8.901478,67.860894,448759,1935
167.235.145.223,157.52.78.29,832,12740225,382,12697735,450,42490,20.910468,60.098502,1690256,5656
167.235.145.223,157.52.78.31,618,9416214,296,9386832,322,29382,37.952058,43.64769,1720472,5385
167.235.145.223,157.52.106.20,280,2552224,149,2540945,131,11279,33.03346,6.440287,3156312,14010
167.235.145.223,157.52.106.21,485,9135815,255,9112313,230,23502,42.262478,38.813962,1878151,4844
167.235.145.223,157.52.106.25,440,7294206,220,7272585,220,21621,3.036453,54.031937,1076783,3201
167.235.145.223,157.52.106.36,8,666,4,402,4,264,37.285571,8.1907,392,257
167.235.145.223,157.52.106.39,4,333,2,201,2,132,51.458408,0.027425,58632,38505
167.235.145.223,162.158.18.38,4,295,3,229,1,66,11.368412,0.032865,55743,16065
167.235.145.223,162.158.18.45,4,295,3,229,1,66,4.778517,0.032353,56625,16319
167.235.145.223,162.158.18.49,8,590,6,458,2,132,25.632491,0.351496,10424,3004
167.235.145.223,162.158.18.95,5,361,3,229,2,132,21.189465,0.034676,52831,30453
167.235.145.223,162.158.18.105,4,295,3,229,1,66,13.671673,0.029925,61219,17644
167.235.145.223,162.158.18.130,5,361,3,229,2,132,7.687388,0.032509,56353,32483
167.235.145.223,162.158.18.173,4,295,3,229,1,66,26.379441,0.032299,56720,16347
167.235.145.223,162.158.18.180,4,295,3,229,1,66,19.655337,0.034753,52714,15192
167.235.145.223,162.158.18.185,5,361,3,229,2,132,10.946757,0.034524,53064,30587
167.235.145.223,162.158.18.187,6,427,3,229,3,198,10.985369,0.034674,52834,45682
167.235.145.223,162.158.19.92,4,295,3,229,1,66,13.253505,0.032294,56728,16349
167.235.145.223,162.158.19.126,4,295,3,229,1,66,19.838342,0.034623,52912,15249
167.235.145.223,162.158.19.164,346,2911585,184,2898643,162,12942,1.585423,80.79676,287005,1281
167.235.145.223,162.158.22.25,5,361,3,229,2,132,19.823401,0.018385,99646,57438
167.235.145.223,162.158.22.29,4,295,3,229,1,66,13.836387,0.019475,94069,27111
167.235.145.223,162.158.22.33,4,295,3,229,1,66,25.859397,0.018694,97999,28244
167.235.145.223,162.158.22.117,4,295,3,229,1,66,7.824407,0.018633,98320,28336
167.235.145.223,162.158.22.210,4,295,3,229,1,66,1.843398,0.020162,90864,26187
167.235.145.223,162.158.33.136,4,295,3,229,1,66,1.314398,0.023397,78300,22566
167.235.145.223,162.158.60.133,360,2395850,180,2382497,180,13353,8.615556,66.281993,287558,1611
167.235.145.223,162.158.60.137,4,295,3,229,1,66,26.654556,0.030851,59382,17114
167.235.145.223,162.158.62.33,4,295,3,229,1,66,7.890692,0.084303,21731,6263
167.235.145.223,162.158.62.186,4,295,3,229,1,66,1.89243,0.082354,22245,6411
167.235.145.223,162.158.62.205,5,361,3,229,2,132,13.911346,0.084196,21758,12542
167.235.145.223,162.158.62.249,5,361,3,229,2,132,25.887569,0.082306,22258,12830
167.235.145.223,162.158.63.132,5,361,3,229,2,132,19.89937,0.084172,21764,12545
167.235.145.223,162.158.74.31,4,295,3,229,1,66,14.448492,0.021335,85868,24748
167.235.145.223,162.158.74.36,261,2130090,142,2120837,119,9253,26.37241,42.34814,400647,1747
167.235.145.223,162.158.74.41,5,361,3,229,2,132,20.569396,0.042127,43487,25067
167.235.145.223,162.158.74.65,4,295,3,229,1,66,11.347416,0.02352,77891,22448
167.235.145.223,162.158.74.111,4,295,3,229,1,66,2.10135,0.04113,44541,12837
167.235.145.223,162.158.86.86,4,295,3,229,1,66,22.472529,0.004032,,
167.235.145.223,162.158.86.127,4,295,3,229,1,66,2.452461,0.00414,,
167.235.145.223,162.158.86.162,4,295,3,229,1,66,8.445465,0.004128,,
167.235.145.223,162.158.86.233,6,427,3,229,3,198,14.450416,0.004262,,
167.235.145.223,162.158.87.50,25,9963,13,7093,12,2870,14.007421,64.872895,874,353
167.235.145.223,162.158.87.88,4,295,3,229,1,66,26.457498,0.004067,,
167.235.145.223,162.158.87.108,4,295,3,229,1,66,28.488447,0.004131,,
167.235.145.223,162.158.87.132,4,295,3,229,1,66,8.013351,0.004132,,
167.235.145.223,162.158.87.169,5,361,3,229,2,132,2.82942,0.004087,,
167.235.145.223,162.158.87.195,4,295,3,229,1,66,10.486514,0.004103,,
167.235.145.223,162.158.94.77,4,295,3,229,1,66,20.010463,0.004106,,
167.235.145.223,162.158.94.83,5,361,3,229,2,132,2.267732,0.004362,,
167.235.145.223,162.158.94.122,4,295,3,229,1,66,13.709443,0.004277,,
167.235.145.223,162.158.94.179,4,295,3,229,1,66,7.729395,0.004107,,
167.235.145.223,162.158.94.191,4,295,3,229,1,66,1.599625,0.004059,,
167.235.145.223,162.158.94.210,4,295,3,229,1,66,25.96852,0.004053,,
167.235.145.223,162.158.94.212,4,295,3,229,1,66,1.550377,0.004035,,
167.235.145.223,162.158.94.218,4,295,3,229,1,66,15.460444,0.004043,,
167.235.145.223,162.158.94.244,5,361,3,229,2,132,27.236379,0.004062,,
167.235.145.223,162.158.95.65,4,295,3,229,1,66,7.816378,0.004059,,
167.235.145.223,162.158.95.69,4,295,3,229,1,66,25.729453,0.004167,,
167.235.145.223,162.158.95.77,5,361,3,229,2,132,26.26356,0.004029,,
167.235.145.223,162.158.95.137,5,361,3,229,2,132,1.721464,0.003939,,
167.235.145.223,162.158.95.163,164,2429440,82,2421852,82,7588,20.289358,51.447553,376593,1179
167.235.145.223,162.158.95.194,5,361,3,229,2,132,14.267642,0.003959,,
167.235.145.223,162.158.95.209,4,295,3,229,1,66,10.585597,0.003981,,
167.235.145.223,162.158.95.216,5,361,3,229,2,132,8.28859,0.003989,,
167.235.145.223,162.158.102.137,4,295,3,229,1,66,25.4534,0.028386,64538,18600
167.235.145.223,162.158.102.194,4,295,3,229,1,66,13.431362,0.026795,68370,19705
167.235.145.223,162.158.103.14,4,295,3,229,1,66,7.438395,0.027691,66158,19067
167.235.145.223,162.158.110.9,4,295,3,229,1,66,29.038495,0.004397,,
167.235.145.223,162.158.110.77,4,295,3,229,1,66,24.555492,0.004032,,
167.235.145.223,162.158.110.103,4,295,3,229,1,66,28.435535,0.00412,,
167.235.145.223,162.158.110.150,4,295,3,229,1,66,23.382413,0.004092,,
167.235.145.223,162.158.110.176,4,295,3,229,1,66,26.382628,0.004157,,
167.235.145.223,162.158.110.177,8,590,6,458,2,132,16.97744,5.427065,675,194
167.235.145.223,162.158.110.178,4,295,3,229,1,66,29.437364,0.004195,,
167.235.145.223,162.158.110.197,5,361,3,229,2,132,10.85557,0.00392,,
167.235.145.223,162.158.110.199,342,8005155,190,7992166,152,12989,12.552403,59.959406,1066343,1733
167.235.145.223,162.158.110.220,4,295,3,229,1,66,17.330347,0.004081,,
167.235.145.223,162.158.110.232,4,295,3,229,1,66,18.152621,0.00408,,
167.235.145.223,162.158.110.242,4,295,3,229,1,66,23.387943,0.004033,,
167.235.145.223,162.158.110.254,5,361,3,229,2,132,11.398398,0.004024,,
167.235.145.223,162.158.111.14,4,295,3,229,1,66,5.35344,0.004122,,
167.235.145.223,162.158.111.19,4,295,3,229,1,66,22.977408,0.004031,,
167.235.145.223,162.158.111.159,161,2778940,86,2771682,75,7258,0.550406,55.284817,401076,1050
167.235.145.223,162.158.111.191,172,2882049,90,2874391,82,7658,18.586507,42.003968,547451,1458
167.235.145.223,162.158.111.198,4,295,3,229,1,66,20.05534,0.003938,,
167.235.145.223,162.158.111.210,4,295,3,229,1,66,4.951261,0.004062,,
167.235.145.223,162.158.129.6,4,295,3,229,1,66,28.757949,0.014853,123342,35548
167.235.145.223,162.158.129.39,4,295,3,229,1,66,4.201179,0.020827,87962,25351
167.235.145.223,162.158.129.43,4,295,3,229,1,66,24.825454,0.013162,139188,40115
167.235.145.223,162.158.129.46,8,590,6,458,2,132,15.514393,2.140081,1712,493
167.235.145.223,162.158.129.73,4,295,3,229,1,66,4.764439,0.015693,116739,33645
167.235.145.223,162.158.129.124,4,295,3,229,1,66,29.640902,0.017866,102541,29553
167.235.145.223,162.158.129.148,4,295,3,229,1,66,22.805416,0.017164,106735,30762
167.235.145.223,162.158.129.165,4,295,3,229,1,66,11.599416,0.013189,138903,40033
167.235.145.223,162.158.129.176,5,361,3,229,2,132,12.476645,0.01794,102118,58862
167.235.145.223,162.158.129.186,5,361,3,229,2,132,3.824793,0.024034,76225,43937
167.235.145.223,162.158.129.194,5,361,3,229,2,132,23.643529,0.021072,86940,50113
167.235.145.223,162.158.129.214,4,295,3,229,1,66,5.211727,0.016266,112627,32460
167.235.145.223,162.158.129.215,4,295,3,229,1,66,5.371431,0.019513,93886,27058
167.235.145.223,162.158.129.245,4,295,3,229,1,66,5.612551,0.015459,118507,34154
167.235.145.223,162.158.129.251,5,361,3,229,2,132,18.815425,0.018935,96752,55769
167.235.145.223,162.158.129.252,8,590,6,458,2,132,10.825483,0.111087,32983,9506
167.235.145.223,162.158.130.8,4,295,3,229,1,66,16.78586,0.01875,97706,28159
167.235.145.223,162.158.130.49,8,590,6,458,2,132,23.129396,0.417467,8776,2529
167.235.145.223,162.158.162.94,4,295,3,229,1,66,10.761506,0.156219,11727,3379
167.235.145.223,162.158.162.207,4,295,3,229,1,66,3.298408,0.236023,7761,2237
167.235.145.223,162.158.163.29,4,295,3,229,1,66,22.601771,0.159519,11484,3309
167.235.145.223,162.158.178.72,800,1490604,414,1463807,386,26797,10.965844,54.23141,215934,3952
167.235.145.223,162.158.178.81,4,295,3,229,1,66,24.006488,0.190364,9623,2773
167.235.145.223,162.158.178.98,4,295,3,229,1,66,5.043616,0.19062,9610,2769
167.235.145.223,162.158.178.156,4,295,3,229,1,66,21.704412,0.188027,9743,2808
167.235.145.223,162.158.178.192,4,295,3,229,1,66,13.541358,0.190304,9626,2774
167.235.145.223,162.158.179.41,4,295,3,229,1,66,20.117434,0.201032,9112,2626
167.235.145.223,162.158.179.143,4,295,3,229,1,66,27.746435,0.182855,10018,2887
167.235.145.223,162.158.186.60,4,295,3,229,1,66,17.780779,0.158285,11574,3335
167.235.145.223,162.158.186.67,6,427,3,229,3,198,5.76243,0.157817,11608,10036
167.235.145.223,162.158.186.159,5,361,3,229,2,132,11.769618,0.156965,11671,6727
167.235.145.223,162.158.202.68,4,295,3,229,1,66,17.709525,0.011744,155994,44959
167.235.145.223,162.158.202.76,4,295,3,229,1,66,23.727418,0.013949,131335,37852
167.235.145.223,162.158.203.101,4,295,3,229,1,66,11.721446,0.011429,160293,46198
167.235.145.223,162.158.203.106,5,361,3,229,2,132,5.66445,0.011421,160406,92461
167.235.145.223,162.158.222.57,4,295,3,229,1,66,6.499397,0.027015,67814,19544
167.235.145.223,162.158.222.68,4,295,3,229,1,66,0.508147,0.026628,68799,19828
167.235.145.223,162.158.222.88,5,361,3,229,2,132,15.449956,0.026677,68673,39584
167.235.145.223,162.158.222.94,4,295,3,229,1,66,27.454483,0.026656,68727,19807
167.235.145.223,162.158.222.136,4,295,3,229,1,66,9.443473,0.027076,67661,19500
167.235.145.223,162.158.222.144,4,295,3,229,1,66,21.350446,0.026815,68319,19690
167.235.145.223,162.158.222.150,5,361,3,229,2,132,24.501463,0.026795,68370,39410
167.235.145.223,162.158.222.247,4,295,3,229,1,66,3.437476,0.026812,68327,19692
167.235.145.223,172.68.50.5,4,295,3,229,1,66,1.573413,0.012666,144639,41686
167.235.145.223,172.68.50.67,4,295,3,229,1,66,22.87442,0.012047,152071,43828
167.235.145.223,172.68.50.144,4,295,3,229,1,66,27.921523,0.012048,152058,43824
167.235.145.223,172.68.51.10,5,361,3,229,2,132,7.678406,0.012633,145017,83590
167.235.145.223,172.68.51.21,382,2436689,210,2423639,172,13050,23.161448,59.891322,323738,1743
167.235.145.223,172.68.51.29,4,295,3,229,1,66,17.167292,0.012725,143968,41493
167.235.145.223,172.68.51.30,4,295,3,229,1,66,19.56084,0.012016,152463,43941
167.235.145.223,172.68.51.73,4,295,3,229,1,66,25.893885,0.01197,153049,44110
167.235.145.223,172.68.51.74,4,295,3,229,1,66,22.941468,0.012053,151995,43806
167.235.145.223,172.68.51.80,4,295,3,229,1,66,8.896503,0.012155,150719,43438
167.235.145.223,172.68.51.108,386,9165416,207,9148701,179,16715,11.923468,67.666351,1081624,1976
167.235.145.223,172.68.51.150,4,295,3,229,1,66,22.291444,0.012123,151117,43553
167.235.145.223,172.68.51.151,4,295,3,229,1,66,29.182513,0.012038,152184,43861
167.235.145.223,172.68.51.209,4,295,3,229,1,66,4.89546,0.011993,152755,44025
167.235.145.223,172.68.62.37,4,295,3,229,1,66,25.97667,0.053792,34057,9815
167.235.145.223,172.68.62.58,4,295,3,229,1,66,2.648394,0.056818,32243,9292
167.235.145.223,172.68.62.70,4,295,3,229,1,66,26.883546,0.056609,32362,9327
167.235.145.223,172.68.62.93,4,295,3,229,1,66,8.524397,0.050873,36011,10378
167.235.145.223,172.68.62.108,4,295,3,229,1,66,19.967684,0.056782,32263,9298
167.235.145.223,172.68.62.153,4,295,3,229,1,66,14.575411,0.04765,38447,11080
167.235.145.223,172.68.62.196,337,1234128,178,1222226,159,11902,1.794421,79.302473,123297,1200
167.235.145.223,172.68.62.210,4,295,3,229,1,66,7.968382,0.050303,36419,10496
167.235.145.223,172.68.62.213,5,361,3,229,2,132,17.043474,0.050346,36388,20974
167.235.145.223,172.68.62.223,4,295,3,229,1,66,13.955496,0.050004,36637,10559
167.235.145.223,172.68.110.13,4,295,3,229,1,66,24.385436,0.00633,289415,83412
167.235.145.223,172.68.110.122,241,4067730,127,4058058,114,9672,8.906448,63.629551,510210,1216
167.235.145.223,172.68.110.139,274,4395027,144,4384299,130,10728,1.956407,76.542672,458233,1121
167.235.145.223,172.68.110.140,4,295,3,229,1,66,13.877425,0.006556,279438,80536
167.235.145.223,172.68.110.158,4,295,3,229,1,66,25.657425,0.006411,285758,82358
167.235.145.223,172.68.110.161,4,295,3,229,1,66,4.86545,0.006889,265931,76643
167.235.145.223,172.68.110.179,4,295,3,229,1,66,1.875404,0.006456,283767,81784
167.235.145.223,172.68.110.196,4,295,3,229,1,66,19.748583,0.006429,284958,82127
167.235.145.223,172.68.130.138,4,295,3,229,1,66,20.991405,0.056867,32215,9284
167.235.145.223,172.68.138.17,4,295,3,229,1,66,19.446646,0.028951,63279,18237
167.235.145.223,172.68.139.37,4,295,3,229,1,66,1.434431,0.028107,65179,18785
167.235.145.223,172.69.43.137,4,295,3,229,1,66,25.586391,0.02049,89409,25768
167.235.145.223,172.69.64.219,6,427,3,229,3,198,6.210602,0.135254,13544,11711
167.235.145.223,172.69.65.94,5,361,3,229,2,132,18.235372,0.134172,13654,7870
167.235.145.223,172.69.65.147,1006,4352895,511,4318425,495,34470,0.002708,65.940939,523914,4181
167.235.145.223,172.69.67.153,5,361,3,229,2,132,24.299483,0.136674,13404,7726
167.235.145.223,172.69.67.159,5,361,3,229,2,132,12.313785,0.134861,13584,7830
167.235.145.223,172.69.67.169,5,361,3,229,2,132,0.189417,0.130981,13986,8062
167.235.145.223,172.69.70.41,4,295,3,229,1,66,20.598419,0.113127,16194,4667
167.235.145.223,172.69.70.158,5,361,3,229,2,132,17.999383,0.112991,16213,9345
167.235.145.223,172.69.71.75,4,295,3,229,1,66,19.306404,0.113094,16198,4668
167.235.145.223,172.69.71.104,5,361,3,229,2,132,22.521517,0.113041,16206,9341
167.235.145.223,172.69.71.114,5,361,3,229,2,132,16.537485,0.113174,16187,9330
167.235.145.223,172.69.71.211,5,361,3,229,2,132,28.519372,0.112903,16226,9353
167.235.145.223,172.69.79.133,5,361,3,229,2,132,0.078414,0.020465,89518,51600
167.235.145.223,172.69.79.172,4,295,3,229,1,66,13.361407,0.020335,90090,25965
167.235.145.223,172.69.79.183,5,361,3,229,2,132,14.742502,0.038062,48131,27744
167.235.145.223,172.69.150.23,4,295,3,229,1,66,2.667484,0.003983,,
167.235.145.223,172.69.150.81,9,656,6,458,3,198,16.747734,0.465681,7868,3401
167.235.145.223,172.69.150.96,4,295,3,229,1,66,8.661448,0.004629,,
167.235.145.223,172.69.150.138,4,295,3,229,1,66,25.862414,0.004208,,
167.235.145.223,172.69.150.153,4,295,3,229,1,66,14.661457,0.004007,,
167.235.145.223,172.69.150.175,9,656,6,458,3,198,22.709101,0.433721,8447,3652
167.235.145.223,172.69.151.22,5,361,3,229,2,132,13.872887,0.003968,,
167.235.145.223,172.69.151.35,4,295,3,229,1,66,18.630459,0.00423,,
167.235.145.223,172.69.151.43,4,295,3,229,1,66,26.664895,0.003974,,
167.235.145.223,172.69.151.74,4,295,3,229,1,66,1.881381,0.004095,,
167.235.145.223,172.69.165.18,4,295,3,229,1,66,25.853353,0.168047,10901,3141
167.235.145.223,172.69.194.26,251,2784829,141,2775312,110,9517,24.504233,30.01808,739637,2536
167.235.145.223,172.69.194.39,4,295,3,229,1,66,19.58748,0.023418,78230,22546
167.235.145.223,172.69.194.46,4,295,3,229,1,66,17.057211,0.021678,84509,24356
167.235.145.223,172.69.194.134,4,295,3,229,1,66,1.59584,0.020592,88966,25641
167.235.145.223,172.69.194.160,4,295,3,229,1,66,25.194373,0.021253,86199,24843
167.235.145.223,172.69.194.221,4,295,3,229,1,66,6.79938,0.020345,90046,25952
167.235.145.223,172.69.195.37,8,590,6,458,2,132,17.587402,0.070281,52133,15025
167.235.145.223,172.69.195.63,4,295,3,229,1,66,19.165421,0.022019,83200,23979
167.235.145.223,172.69.195.94,5,361,3,229,2,132,3.448373,0.022017,83208,47962
167.235.145.223,172.69.195.141,4,295,3,229,1,66,0.537445,0.021386,85663,24689
167.235.145.223,172.69.195.178,5,361,3,229,2,132,13.589481,0.020316,90175,51978
167.235.145.223,172.69.195.230,5,361,3,229,2,132,7.617557,0.02228,82226,47396
167.235.145.223,172.69.222.14,5,361,3,229,2,132,7.051447,0.015269,119981,69159
167.235.145.223,172.69.222.36,5,361,3,229,2,132,8.177531,0.012898,142037,81873
167.235.145.223,172.69.222.57,4,295,3,229,1,66,26.50471,0.015291,119809,34530
167.235.145.223,172.69.222.79,5,361,3,229,2,132,18.181458,0.015112,121228,69878
167.235.145.223,172.69.222.109,4,295,3,229,1,66,2.845797,0.015508,118132,34046
167.235.145.223,172.69.222.134,5,361,3,229,2,132,1.632386,0.015389,119046,68620
167.235.145.223,172.69.222.150,4,295,3,229,1,66,13.854412,0.015111,121236,34941
167.235.145.223,172.69.222.155,4,295,3,229,1,66,12.188433,0.012775,143405,41330
167.235.145.223,172.69.222.161,339,4166276,180,4151873,159,14403,23.463357,32.753456,1014090,3517
167.235.145.223,172.69.222.171,4,295,3,229,1,66,19.27074,0.015347,119371,34404
167.235.145.223,172.69.222.200,4,295,3,229,1,66,10.965399,0.015121,121156,34918
167.235.145.223,172.69.222.201,4,295,3,229,1,66,11.177394,0.016219,112953,32554
167.235.145.223,172.69.222.212,4,295,3,229,1,66,17.021326,0.014499,126353,36416
167.235.145.223,172.69.222.213,4,295,3,229,1,66,17.260699,0.012791,143225,41279
167.235.145.223,172.69.222.252,4,295,3,229,1,66,20.116378,0.015037,121832,35113
167.235.145.223,172.69.223.29,4,295,3,229,1,66,1.581412,0.012509,146454,42209
167.235.145.223,172.69.223.56,4,295,3,229,1,66,8.142608,0.014401,127213,36664
167.235.145.223,172.69.223.61,4,295,3,229,1,66,29.687476,0.014416,127081,36625
167.235.145.223,172.69.223.74,163,1255901,83,1249102,80,6799,24.203363,57.928116,172503,938
167.235.145.223,172.69.223.139,4,295,3,229,1,66,25.920455,0.014352,127647,36789
167.235.145.223,172.69.223.186,4,295,3,229,1,66,7.301326,0.012307,148858,42902
167.235.145.223,172.70.34.70,5,361,3,229,2,132,26.901967,0.101657,18021,10387
167.235.145.223,172.70.34.117,4,295,3,229,1,66,14.941438,0.102325,17903,5160
167.235.145.223,172.70.34.131,4,295,3,229,1,66,9.096443,0.099893,18339,5285
167.235.145.223,172.70.34.139,4,295,3,229,1,66,21.004488,0.10192,17974,5180
167.235.145.223,172.70.35.72,4,295,3,229,1,66,2.935434,0.099939,18331,5283
167.235.145.223,172.70.46.32,4,295,3,229,1,66,9.458626,0.009517,192497,55479
167.235.145.223,172.70.46.34,4,295,3,229,1,66,25.667433,0.009552,191792,55276
167.235.145.223,172.70.46.78,4,295,3,229,1,66,19.818497,0.009584,191151,55091
167.235.145.223,172.70.46.102,4,295,3,229,1,66,7.141529,0.009471,193432,55749
167.235.145.223,172.70.46.107,4,295,3,229,1,66,20.312421,0.009446,193944,55896
167.235.145.223,172.70.46.150,4,295,3,229,1,66,10.901509,0.009481,193228,55690
167.235.145.223,172.70.46.157,4,295,3,229,1,66,15.440476,0.009497,192903,55596
167.235.145.223,172.70.46.171,4,295,3,229,1,66,1.599637,0.009567,191491,55189
167.235.145.223,172.70.46.178,4,295,3,229,1,66,5.741477,0.009708,188710,54388
167.235.145.223,172.70.47.3,8,590,6,458,2,132,28.984396,0.065483,55953,16126
167.235.145.223,172.70.47.6,4,295,3,229,1,66,2.016425,0.009508,192679,55532
167.235.145.223,172.70.47.10,4,295,3,229,1,66,3.560001,0.009436,194150,55955
167.235.145.223,172.70.85.25,4,295,3,229,1,66,12.266279,0.021392,85639,24682
167.235.145.223,172.70.85.36,4,295,3,229,1,66,0.239571,0.020376,89909,25912
167.235.145.223,172.70.85.94,5,361,3,229,2,132,23.305725,0.021588,84861,48916
167.235.145.223,172.70.85.236,4,295,3,229,1,66,24.266567,0.022098,82903,23893
167.235.145.223,172.70.86.93,4,295,3,229,1,66,10.888432,0.020256,90442,26066
167.235.145.223,172.70.86.125,4,295,3,229,1,66,18.289475,0.021235,86272,24864
167.235.145.223,172.70.86.154,177,1223483,103,1217276,74,6207,17.279388,63.894198,152411,777
167.235.145.223,172.70.86.195,5,361,3,229,2,132,5.296399,0.021442,85439,49249
167.235.145.223,172.70.90.36,4,295,3,229,1,66,19.530356,0.021147,86631,24968
167.235.145.223,172.70.90.119,4,295,3,229,1,66,25.53176,0.021405,85587,24667
167.235.145.223,172.70.90.130,4,295,3,229,1,66,3.865398,0.021315,85948,24771
167.235.145.223,172.70.90.204,4,295,3,229,1,66,21.85536,0.021007,87209,25134
167.235.145.223,172.70.90.231,4,295,3,229,1,66,27.867477,0.021876,83744,24136
167.235.145.223,172.70.91.18,4,295,3,229,1,66,1.523344,0.020397,89817,25886
167.235.145.223,172.70.91.97,4,295,3,229,1,66,7.530378,0.020352,90015,25943
167.235.145.223,172.70.91.198,5,361,3,229,2,132,15.862788,0.021176,86513,49867
167.235.145.223,172.70.92.200,600,1197124,332,1178159,268,18965,6.992657,60.118912,156777,2523
167.235.145.223,172.70.93.3,4,295,3,229,1,66,24.981441,0.161076,11373,3277
167.235.145.223,172.70.93.9,4,295,3,229,1,66,19.435408,0.219178,8358,2409
167.235.145.223,172.70.93.10,4,295,3,229,1,66,7.36846,0.154375,11867,3420
167.235.145.223,172.70.147.17,5,361,3,229,2,132,24.916399,0.169104,10833,6244
167.235.145.223,172.70.147.97,4,295,3,229,1,66,0.970444,0.160528,11412,3289
167.235.145.223,172.70.147.182,4,295,3,229,1,66,12.964371,0.16368,11192,3225
167.235.145.223,172.70.147.190,4,295,3,229,1,66,1.300435,0.154541,11854,3416
167.235.145.223,172.70.147.200,4,295,3,229,1,66,13.355724,0.168382,10880,3135
167.235.145.223,172.70.210.17,5,361,3,229,2,132,3.736442,0.157348,11642,6711
167.235.145.223,172.70.210.116,4,295,3,229,1,66,15.763415,0.162093,11302,3257
167.235.145.223,172.70.211.92,4,295,3,229,1,66,27.733489,0.156574,11700,3372
167.235.145.223,172.70.211.116,4,295,3,229,1,66,9.761463,0.158657,11546,3327
167.235.145.223,172.70.211.214,4,295,3,229,1,66,21.777414,0.161875,11317,3261
167.235.145.223,172.70.242.11,4,295,3,229,1,66,21.44699,0.004074,,
167.235.145.223,172.70.242.79,4,295,3,229,1,66,27.940443,0.004083,,
167.235.145.223,172.70.242.80,4,295,3,229,1,66,9.53139,0.003997,,
167.235.145.223,172.70.242.87,4,295,3,229,1,66,18.635393,0.004052,,
167.235.145.223,172.70.242.96,5,361,3,229,2,132,3.318448,0.003901,,
167.235.145.223,172.70.242.98,4,295,3,229,1,66,15.363413,0.004106,,
167.235.145.223,172.70.242.151,5,361,3,229,2,132,21.741385,0.004004,,
167.235.145.223,172.70.242.158,4,295,3,229,1,66,4.982445,0.004901,,
167.235.145.223,172.70.242.174,4,295,3,229,1,66,28.951521,0.003995,,
167.235.145.223,172.70.242.241,4,295,3,229,1,66,3.64239,0.004089,,
167.235.145.223,172.70.243.32,4,295,3,229,1,66,10.181484,0.00462,,
167.235.145.223,172.70.243.177,4,295,3,229,1,66,12.386002,0.004027,,
167.235.145.223,172.70.243.215,5,361,3,229,2,132,3.558491,0.003903,,
167.235.145.223,172.70.246.20,4,295,3,229,1,66,27.238656,0.004033,,
167.235.145.223,172.70.246.68,4,295,3,229,1,66,10.579481,0.004158,,
167.235.145.223,172.70.246.72,4,295,3,229,1,66,18.982373,0.004324,,
167.235.145.223,172.70.246.197,4,295,3,229,1,66,26.841384,0.00401,,
167.235.145.223,172.70.246.201,156,2453068,79,2445776,77,7292,3.081437,77.862375,251292,749
167.235.145.223,172.70.246.208,4,295,3,229,1,66,15.160904,0.003941,,
167.235.145.223,172.70.246.212,4,295,3,229,1,66,8.841832,0.00402,,
167.235.145.223,172.70.246.253,4,295,3,229,1,66,2.828514,0.003885,,
167.235.145.223,172.70.247.50,4,295,3,229,1,66,6.959433,0.004017,,
167.235.145.223,172.70.247.99,5,361,3,229,2,132,9.079544,0.004065,,
167.235.145.223,172.70.247.177,4,295,3,229,1,66,14.854479,0.003975,,
167.235.145.223,172.70.247.197,4,295,3,229,1,66,0.963413,0.004013,,
167.235.145.223,172.70.250.41,408,11277292,218,11259386,190,17906,0.825432,60.510025,1488597,2367
167.235.145.223,172.70.250.128,5,361,3,229,2,132,21.134662,0.004036,,
167.235.145.223,172.70.250.139,4,295,3,229,1,66,11.564486,0.004008,,
167.235.145.223,172.70.250.146,4,295,3,229,1,66,28.014555,0.00411,,
167.235.145.223,172.70.250.181,4,295,3,229,1,66,17.606957,0.004085,,
167.235.145.223,172.70.250.219,4,295,3,229,1,66,23.649429,0.004053,,
167.235.145.223,172.70.250.237,4,295,3,229,1,66,24.832645,0.004076,,
167.235.145.223,172.70.251.40,4,295,3,229,1,66,16.735567,0.004098,,
167.235.145.223,172.70.251.52,4,295,3,229,1,66,29.900647,0.004195,,
167.235.145.223,172.70.251.64,4,295,3,229,1,66,29.230715,0.004106,,
167.235.145.223,172.70.251.119,4,295,3,229,1,66,15.153273,0.003982,,
167.235.145.223,172.70.251.124,4,295,3,229,1,66,6.838377,0.004166,,
167.235.145.223,172.70.251.205,4,295,3,229,1,66,3.637413,0.004039,,
167.235.145.223,172.70.251.219,5,361,3,229,2,132,3.128513,0.004131,,
167.235.145.223,172.71.94.48,4,295,3,229,1,66,11.937473,0.009578,191271,55126
167.235.145.223,172.71.94.51,225,2329589,111,2320675,114,8914,24.752417,37.720125,492188,1890
167.235.145.223,172.71.94.52,242,4225867,130,4215578,112,10289,14.725701,59.442006,567353,1384
167.235.145.223,172.71.94.83,8,590,6,458,2,132,23.29637,3.699677,990,285
167.235.145.223,172.71.94.87,4,295,3,229,1,66,5.4384,0.009634,190159,54805
167.235.145.223,172.71.94.93,8,590,6,458,2,132,5.306477,3.699473,990,285
167.235.145.223,172.71.94.122,209,2507962,98,2498253,111,9709,17.199448,62.979725,317340,1233
167.235.145.223,172.71.94.146,4,295,3,229,1,66,25.260544,0.009457,193718,55831
167.235.145.223,172.71.94.196,4,295,3,229,1,66,24.334459,0.009647,189903,54732
167.235.145.223,172.71.94.201,4,295,3,229,1,66,23.07238,0.00946,193657,55813
167.235.145.223,172.71.94.215,130,997589,68,991967,62,5622,6.084514,67.750712,117131,663
167.235.145.223,172.71.94.228,4,295,3,229,1,66,5.47944,0.009584,191151,55091
167.235.145.223,172.71.94.252,470,6472985,247,6454643,223,18342,17.259526,44.745762,1154011,3279
167.235.145.223,172.71.98.36,4,295,3,229,1,66,13.765357,0.009641,190021,54766
167.235.145.223,172.71.98.42,4,295,3,229,1,66,25.764568,0.009471,193432,55749
167.235.145.223,172.71.98.90,5,361,3,229,2,132,12.067035,0.009367,195580,112736
167.235.145.223,172.71.98.134,4,295,3,229,1,66,6.174396,0.009489,193065,55643
167.235.145.223,172.71.98.172,155,1508492,84,1502274,71,6218,7.260761,48.92039,245668,1016
167.235.145.223,172.71.98.232,4,295,3,229,1,66,3.920498,0.00964,190041,54771
167.235.145.223,172.71.98.247,4,295,3,229,1,66,19.289372,0.009708,188710,54388
167.235.145.223,172.71.99.22,4,295,3,229,1,66,17.947494,0.009503,192781,55561
167.235.145.223,172.71.99.40,4,295,3,229,1,66,13.578446,0.009692,189021,54477
167.235.145.223,172.71.99.145,4,295,3,229,1,66,1.240403,0.009421,194459,56045
167.235.145.223,172.71.99.196,4,295,3,229,1,66,23.833457,0.009622,190397,54874
167.235.145.223,172.71.99.200,4,295,3,229,1,66,19.688337,0.009547,191892,55305
167.235.145.223,172.71.99.235,4,295,3,229,1,66,1.687368,0.009536,192114,55369
167.235.145.223,172.71.102.24,4,295,3,229,1,66,25.979416,0.009622,190397,54874
167.235.145.223,172.71.102.46,4,295,3,229,1,66,29.270451,0.009452,193821,55861
167.235.145.223,172.71.102.80,4,295,3,229,1,66,17.268495,0.009737,188148,54226
167.235.145.223,172.71.102.94,4,295,3,229,1,66,9.931498,0.009509,192659,55526
167.235.145.223,172.71.102.131,4,295,3,229,1,66,23.284777,0.00942,194479,56050
167.235.145.223,172.71.102.149,4,295,3,229,1,66,11.287453,0.009496,192923,55602
167.235.145.223,172.71.102.199,4,295,3,229,1,66,4.986488,0.009879,185443,53446
167.235.145.223,172.71.102.211,4,295,3,229,1,66,21.271036,0.009949,184139,53070
167.235.145.223,172.71.102.212,4,295,3,229,1,66,10.788474,0.016804,109021,31421
167.235.145.223,172.71.102.254,4,295,3,229,1,66,19.607361,0.00956,191631,55230
167.235.145.223,172.71.103.53,4,295,3,229,1,66,1.935569,0.01031,177691,51212
167.235.145.223,172.71.103.84,9,656,6,458,3,198,13.43384,0.112422,32591,14089
167.235.145.223,172.71.103.92,4,295,3,229,1,66,27.935433,0.009461,193637,55808
167.235.145.223,172.71.103.123,4,295,3,229,1,66,29.195477,0.009661,189628,54652
167.235.145.223,172.71.103.127,4,295,3,229,1,66,23.107465,0.009856,185876,53571
167.235.145.223,172.71.103.128,5,361,3,229,2,132,22.927765,0.009542,191993,110668
167.235.145.223,172.71.103.162,5,361,3,229,2,132,13.711526,0.010226,179151,103266
167.235.145.223,172.71.103.228,4,295,3,229,1,66,3.053372,0.00957,191431,55172
167.235.145.223,172.71.103.230,4,295,3,229,1,66,21.923387,0.009385,195205,56259
167.235.145.223,172.71.114.2,4,295,3,229,1,66,2.294423,0.021418,85535,24652
167.235.145.223,172.71.114.16,4,295,3,229,1,66,7.411408,0.014817,123641,35634
167.235.145.223,172.71.114.31,276,2128150,142,2117828,134,10322,18.954547,48.613709,348515,1698
167.235.145.223,172.71.114.46,4,295,3,229,1,66,20.915412,0.013018,140728,40559
167.235.145.223,172.71.114.67,233,2387473,136,2379593,97,7880,1.069459,66.262686,287292,951
167.235.145.223,172.71.114.70,4,295,3,229,1,66,25.186464,0.021409,85571,24662
167.235.145.223,172.71.114.71,175,1313902,101,1307529,74,6373,25.07666,38.106755,274498,1337
167.235.145.223,172.71.114.99,4,295,3,229,1,66,13.097533,0.018432,99392,28645
167.235.145.223,172.71.114.108,249,2225837,144,2217429,105,8408,29.251533,50.179928,353516,1340
167.235.145.223,172.71.114.117,4,295,3,229,1,66,6.966434,0.015097,121348,34973
167.235.145.223,172.71.114.148,4,295,3,229,1,66,26.310933,0.014364,127541,36758
167.235.145.223,172.71.114.157,4,295,3,229,1,66,8.317589,0.013738,133352,38433
167.235.145.223,172.71.114.222,5,361,3,229,2,132,7.107532,0.018296,100131,57717
167.235.145.223,172.71.115.32,4,295,3,229,1,66,12.691472,0.021515,85149,24541
167.235.145.223,172.71.115.63,4,295,3,229,1,66,13.171859,0.01483,123533,35603
167.235.145.223,172.71.115.64,4,295,3,229,1,66,13.064367,0.018399,99570,28697
167.235.145.223,172.71.122.8,4,295,3,229,1,66,2.149412,0.012857,142490,41067
167.235.145.223,172.71.122.27,4,295,3,229,1,66,12.212938,0.015147,120948,34858
167.235.145.223,172.71.122.82,4,295,3,229,1,66,17.740643,0.015237,120233,34652
167.235.145.223,172.71.122.128,4,295,3,229,1,66,1.525416,0.015445,118614,34185
167.235.145.223,172.71.122.181,4,295,3,229,1,66,25.839407,0.015302,119722,34505
167.235.145.223,172.71.122.205,4,295,3,229,1,66,11.398452,0.015393,119015,34301
167.235.145.223,172.71.122.246,4,295,3,229,1,66,0.981756,0.012986,141075,40659
167.235.145.223,172.71.123.5,4,295,3,229,1,66,5.382452,0.013031,140587,40518
167.235.145.223,172.71.123.109,5,361,3,229,2,132,23.680592,0.012501,146548,84473
167.235.145.223,172.71.123.144,4,295,3,229,1,66,18.206884,0.012194,150237,43299
167.235.145.223,172.71.123.158,4,295,3,229,1,66,14.129432,0.01239,147861,42615
167.235.145.223,172.71.130.18,4,295,3,229,1,66,23.543642,0.012207,150077,43253
167.235.145.223,172.71.130.36,4,295,3,229,1,66,12.635585,0.012257,149465,43077
167.235.145.223,172.71.130.41,4,295,3,229,1,66,24.691442,0.012429,147397,42481
167.235.145.223,172.71.130.93,4,295,3,229,1,66,12.688003,0.012513,146407,42196
167.235.145.223,172.71.130.158,173,1241285,89,1234429,84,6856,18.714637,45.929021,215015,1194
167.235.145.223,172.71.130.169,4,295,3,229,1,66,6.789385,0.014617,125333,36122
167.235.145.223,172.71.130.170,5,361,3,229,2,132,29.172518,0.012189,150299,86635
167.235.145.223,172.71.130.186,4,295,3,229,1,66,0.649458,0.014587,125591,36196
167.235.145.223,172.71.131.7,4,295,3,229,1,66,12.862417,0.01465,125051,36040
167.235.145.223,172.71.131.38,4,295,3,229,1,66,17.60547,0.012221,149905,43204
167.235.145.223,172.71.131.47,4,295,3,229,1,66,6.629368,0.012304,148894,42912
167.235.145.223,172.71.131.50,4,295,3,229,1,66,1.615444,0.012408,147646,42553
167.235.145.223,172.71.131.55,310,5193448,174,5182108,136,11340,1.129391,78.986217,524862,1148
167.235.145.223,172.71.131.109,4,295,3,229,1,66,0.683605,0.012316,148749,42871
167.235.145.223,172.71.131.177,4,295,3,229,1,66,28.094476,0.012499,146571,42243
167.235.145.223,172.71.131.187,4,295,3,229,1,66,1.937352,0.012398,147765,42587
167.235.145.223,172.71.134.48,4,295,3,229,1,66,26.473399,0.011994,152743,44022
167.235.145.223,172.71.134.85,5,361,3,229,2,132,8.793742,0.01431,128022,73794
167.235.145.223,172.71.134.116,374,7420138,206,7405736,168,14402,0.367415,72.456703,817672,1590
167.235.145.223,172.71.134.124,4,295,3,229,1,66,20.561449,0.01213,151030,43528
167.235.145.223,172.71.134.142,4,295,3,229,1,66,14.446437,0.011899,153962,44373
167.235.145.223,172.71.134.173,4,295,3,229,1,66,26.502464,0.011828,154886,44639
167.235.145.223,172.71.134.246,4,295,3,229,1,66,2.446368,0.011752,155888,44928
167.235.145.223,172.71.135.12,5,361,3,229,2,132,24.432454,0.01207,151781,87489
167.235.145.223,172.71.135.39,4,295,3,229,1,66,11.514443,0.012396,147789,42594
167.235.145.223,172.71.135.95,4,295,3,229,1,66,8.484464,0.014812,123683,35646
167.235.145.223,172.71.135.100,193,2323020,107,2315040,86,7980,20.460432,48.192056,384302,1324
167.235.145.223,172.71.135.114,4,295,3,229,1,66,2.614544,0.01437,127487,36743
167.235.145.223,172.71.160.23,4,295,3,229,1,66,8.022359,0.013521,135492,39050
167.235.145.223,172.71.182.70,4,295,3,229,1,66,26.545379,0.009365,195621,56380
167.235.145.223,172.71.182.87,4,295,3,229,1,66,12.873452,0.009758,187743,54109
167.235.145.223,172.71.182.93,4,295,3,229,1,66,11.506439,0.009515,192538,55491
167.235.145.223,172.71.182.146,4,295,3,229,1,66,24.866097,0.009539,192053,55351
167.235.145.223,172.71.182.151,4,295,3,229,1,66,23.215381,0.009499,192862,55584
167.235.145.223,172.71.182.156,4,295,3,229,1,66,29.825392,0.009498,192882,55590
167.235.145.223,172.71.182.163,4,295,3,229,1,66,2.535388,0.009547,191892,55305
167.235.145.223,172.71.182.178,4,295,3,229,1,66,16.95547,0.009493,192984,55619
167.235.145.223,172.71.182.190,4,295,3,229,1,66,20.737456,0.0095,192842,55578
167.235.145.223,172.71.182.197,4,295,3,229,1,66,6.913565,0.009463,193596,55796
167.235.145.223,172.71.182.219,4,295,3,229,1,66,10.997617,0.009549,191852,55293
167.235.145.223,172.71.182.222,4,295,3,229,1,66,5.07253,0.009561,191611,55224
167.235.145.223,172.71.182.254,5,361,3,229,2,132,17.98545,0.009596,190912,110045
167.235.145.223,172.71.242.4,4,295,3,229,1,66,13.654388,0.021897,83664,24112
167.235.145.223,172.71.242.32,4,295,3,229,1,66,1.651366,0.021244,86236,24854
167.235.145.223,172.71.242.58,4,295,3,229,1,66,19.643515,0.022326,82056,23649
167.235.145.223,172.71.242.126,4,295,3,229,1,66,7.585349,0.020663,88660,25552
167.235.145.223,172.71.242.141,4,295,3,229,1,66,25.645596,0.021542,85043,24510
167.235.145.223,172.71.246.13,4,295,3,229,1,66,9.418565,0.004124,,
167.235.145.223,172.71.246.18,4,295,3,229,1,66,21.431499,0.004235,,
167.235.145.223,172.71.246.25,4,295,3,229,1,66,15.381117,0.004026,,
167.235.145.223,172.71.246.54,234,3768325,118,3758410,116,9915,0.710475,74.726239,402365,1061
167.235.145.223,172.71.246.74,4,295,3,229,1,66,6.697419,0.00412,,
167.235.145.223,172.71.246.80,4,295,3,229,1,66,27.410661,0.004124,,
167.235.145.223,172.71.246.125,4,295,3,229,1,66,3.405416,0.004136,,
167.235.145.223,172.71.246.134,4,295,3,229,1,66,18.981392,0.004212,,
167.235.145.223,172.71.250.58,4,295,3,229,1,66,13.498844,0.00419,,
167.235.145.223,172.71.250.80,5,361,3,229,2,132,7.485778,0.004044,,
167.235.145.223,172.71.250.91,4,295,3,229,1,66,19.487617,0.004034,,
167.235.145.223,172.71.250.93,4,295,3,229,1,66,25.509425,0.004041,,
167.235.145.223,172.71.254.50,5,361,3,229,2,132,19.492359,0.129642,14131,8145
167.235.145.223,172.71.254.95,5,361,3,229,2,132,25.402449,0.104784,17483,10077
167.235.145.223,172.71.254.182,4,295,3,229,1,66,1.449527,0.105759,17322,4992
167.235.145.223,172.71.254.198,4,295,3,229,1,66,13.495398,0.133052,13769,3968
167.235.145.223,188.114.102.11,5,361,3,229,2,132,1.987451,0.018272,100262,57793
167.235.145.223,188.114.102.12,192,2172187,113,2164746,79,7441,5.471601,57.687961,300200,1031
167.235.145.223,188.114.102.26,5,361,3,229,2,132,2.379452,0.021219,86337,49766
167.235.145.223,188.114.102.64,5,361,3,229,2,132,20.681585,0.018644,98262,56640
167.235.145.223,188.114.102.70,416,9338986,228,9321806,188,17180,26.389422,55.475021,1344288,2477
167.235.145.223,188.114.102.79,4,295,3,229,1,66,18.886394,0.021157,86590,24956
167.235.145.223,188.114.102.82,4,295,3,229,1,66,12.138492,0.021775,84133,24247
167.235.145.223,188.114.102.89,195,1510957,113,1504189,82,6768,17.542514,45.027598,267247,1202
167.235.145.223,188.114.102.104,8,590,6,458,2,132,23.050413,0.840744,4358,1256
167.235.145.223,188.114.102.133,4,295,3,229,1,66,14.670412,0.018577,98616,28422
167.235.145.223,188.114.102.144,527,13427695,298,13407183,229,20512,3.665425,74.659423,1436623,2197
167.235.145.223,188.114.102.152,4,295,3,229,1,66,0.620298,0.021155,86598,24958
167.235.145.223,188.114.102.162,4,295,3,229,1,66,11.571464,0.018643,98267,28321
167.235.145.223,188.114.102.172,4,295,3,229,1,66,11.147297,0.018469,99193,28588
167.235.145.223,188.114.102.190,347,6912861,185,6899019,162,13842,24.128447,42.25056,1306305,2620
167.235.145.223,188.114.102.224,4,295,3,229,1,66,17.76639,0.012794,143192,41269
167.235.145.223,188.114.102.247,785,482547,262,243245,523,239302,0,82.736209,23520,23138
167.235.145.223,198.41.230.69,5,361,3,229,2,132,10.375828,0.225491,8124,4683
167.235.145.223,198.41.230.114,4,295,3,229,1,66,4.380463,0.225258,8132,2343
167.235.145.223,198.41.230.163,4,295,3,229,1,66,22.378168,0.227252,8061,2323
167.235.145.223,198.41.230.182,5,361,3,229,2,132,27.693485,0.225541,8122,4682
167.235.145.223,198.41.230.184,4,295,3,229,1,66,16.358565,0.217292,8431,2429
167.235.145.223,198.41.242.13,4,295,3,229,1,66,20.036348,0.013164,139167,40109
167.235.145.223,198.41.242.111,4,295,3,229,1,66,2.011422,0.006297,290932,83849
167.235.145.223,198.41.242.171,4,295,3,229,1,66,14.010645,0.013205,138735,39984
167.235.145.223,198.41.242.207,4,295,3,229,1,66,26.044349,0.013577,134934,38889
172.68.50.72,167.235.145.223,1064,655779,706,328073,358,327706,0.191181,82.906371,31657,31621
172.68.50.73,167.235.145.223,1586,984268,1057,495634,529,488634,0.298511,82.454214,48088,47409
172.68.50.75,167.235.145.223,250,2471263,124,10384,126,2460879,22.773143,30.496069,2724,645559
172.68.50.82,167.235.145.223,1785,2638632,795,55260,990,2583372,28.350348,33.022916,13387,625837
172.68.50.83,167.235.145.223,396,4976183,188,14859,208,4961324,28.415887,30.62841,3881,1295875
172.68.50.84,167.235.145.223,1534,950198,1020,476536,514,473662,0.000403,82.45576,46234,45955
172.68.50.85,167.235.145.223,1191,745470,794,377689,397,367781,0.043823,82.87152,36460,35503
172.68.50.146,167.235.145.223,827,1214201,364,24500,463,1189701,0.006901,59.033732,3320,161223
172.68.50.149,167.235.145.223,7,493,3,198,4,295,16.952189,29.612295,53,79
172.68.50.151,167.235.145.223,1015,5218501,415,31141,600,5187360,43.405776,34.070291,7312,1218037
172.68.50.164,167.235.145.223,190,2041092,82,6899,108,2034193,41.067919,30.312141,1820,536865
172.68.50.165,167.235.145.223,247,4068339,106,9387,141,4058952,40.976682,30.914205,2429,1050378
172.68.50.174,167.235.145.223,7,493,3,198,4,295,25.260148,29.69016,53,79
172.68.50.251,167.235.145.223,214,2710017,104,9118,110,2700899,6.177463,60.843591,1198,355126
172.68.50.252,167.235.145.223,308,2336623,117,10022,191,2326601,12.178514,65.944437,1215,282249
172.68.50.254,167.235.145.223,599,6191304,243,18701,356,6172603,12.57185,68.78489,2175,717902
172.68.51.18,167.235.145.223,635,4880073,297,23415,338,4856658,41.251023,12.353725,15163,3145064
172.68.51.22,167.235.145.223,502,12602184,225,19728,277,12582456,46.767111,6.221343,25368,16179729
172.68.51.26,167.235.145.223,417,8929393,186,17237,231,8912156,0.078134,66.345186,2078,1074640
172.68.51.27,167.235.145.223,928,1846953,612,283883,316,1563070,0.049975,81.814655,27758,152840
172.68.51.28,167.235.145.223,1824,2402963,1210,563806,614,1839157,0.071534,83.03333,54320,177196
172.68.51.38,167.235.145.223,6,427,2,132,4,295,25.014805,29.996806,35,78
172.68.51.40,167.235.145.223,670,7262701,282,21273,388,7241428,6.146085,60.802553,2798,952779
172.68.51.44,167.235.145.223,13,920,5,330,8,590,2.33526,29.702533,88,158
172.68.51.45,167.235.145.223,212,7404223,87,8348,125,7395875,10.786453,60.551083,1102,977141
172.68.51.47,167.235.145.223,1352,6526322,634,45141,718,6481181,57.831338,0.990617,364548,52340559
172.68.51.49,167.235.145.223,1391,858605,927,428547,464,430058,0.047881,83.049167,41281,41426
172.68.51.50,167.235.145.223,1389,856925,926,427850,463,429075,0.01936,82.622387,41427,41545
172.68.51.51,167.235.145.223,12,854,4,264,8,590,11.705141,29.538435,71,159
172.68.51.53,167.235.145.223,6,427,2,132,4,295,19.709563,29.697865,35,79
172.68.51.54,167.235.145.223,7,493,3,198,4,295,18.878506,28.134385,56,83
172.68.51.56,167.235.145.223,1440,7039548,655,47784,785,6991764,61.310472,0.462059,827322,121054047
172.68.51.67,167.235.145.223,47,1255036,23,2252,24,1252784,17.194495,60.014923,300,166996
172.68.51.68,167.235.145.223,179,1263840,83,6304,96,1257536,16.434216,60.016452,840,167625
172.68.51.76,167.235.145.223,950,2542490,426,30389,524,2512101,21.405112,60.016589,4050,334854
172.68.51.82,167.235.145.223,409,9136735,191,17478,218,9119257,12.102026,41.929191,3334,1739934
172.68.51.83,167.235.145.223,12,854,4,264,8,590,18.892633,30.062925,70,157
172.68.51.86,167.235.145.223,7,493,3,198,4,295,13.738082,29.9367,52,78
172.68.51.87,167.235.145.223,6,427,2,132,4,295,18.636376,29.577089,35,79
172.68.51.88,167.235.145.223,1269,2282750,550,40250,719,2242500,59.259474,1.758875,183071,10199701
172.68.51.93,167.235.145.223,229,2387342,113,9100,116,2378242,67.723943,0.144253,504668,131892827
172.68.51.94,167.235.145.223,2181,7428171,1023,72079,1158,7356092,67.291882,8.272309,69706,7113943
172.68.51.97,167.235.145.223,1048,7360871,483,35568,565,7325303,65.145066,1.155031,246351,50736667
172.68.51.101,167.235.145.223,1178,3592428,548,39144,630,3553284,30.978917,30.614491,10228,928523
172.68.51.102,167.235.145.223,444,1786798,170,12862,274,1773936,31.171804,30.302648,3395,468325
172.68.51.103,167.235.145.223,260,2665697,122,9603,138,2656094,10.764039,60.494463,1269,351251
172.68.51.112,167.235.145.223,188,2497409,87,8042,101,2489367,81.423281,1.313627,48975,15160266
172.68.51.118,167.235.145.223,7,493,3,198,4,295,29.544046,29.73098,53,79
172.68.51.125,167.235.145.223,1321,2723542,867,406060,454,2317482,0.048242,82.547859,39352,224595
172.68.51.126,167.235.145.223,1308,2645977,835,363814,473,2282163,0.177091,82.673613,35204,220835
172.68.51.127,167.235.145.223,640,2281677,282,20016,358,2261661,4.973717,60.064663,2665,301230
172.68.51.128,167.235.145.223,303,4494064,149,12350,154,4481714,4.930287,60.242131,1640,595160
172.68.51.135,167.235.145.223,400,8009368,190,15912,210,7993456,70.86754,0.71942,176942,88887781
172.68.51.138,167.235.145.223,12,854,4,264,8,590,23.22466,30.657905,68,153
172.68.51.140,167.235.145.223,193,2612217,91,8306,102,2603911,63.419843,3.181995,20882,6546612
172.68.51.141,167.235.145.223,780,482536,520,241597,260,240939,0.412585,82.576878,23405,23342
172.68.51.142,167.235.145.223,1562,966621,1041,483670,521,482951,0.06399,83.035806,46598,46529
172.68.51.155,167.235.145.223,363,1461796,165,12275,198,1449521,29.249949,30.520579,3217,379945
172.68.51.156,167.235.145.223,850,1494021,399,27802,451,1466219,28.773929,30.523157,7286,384290
172.68.51.157,167.235.145.223,1188,736258,792,369411,396,366847,0.208964,82.568358,35792,35543
172.68.51.158,167.235.145.223,1182,729445,788,364208,394,365237,0.436428,82.377941,35369,35469
172.68.51.160,167.235.145.223,365,8305402,146,12952,219,8292450,24.949176,30.595584,3386,2168273
172.68.51.162,167.235.145.223,390,2613188,178,14048,212,2599140,69.436299,0.636005,176703,32693327
172.68.51.164,167.235.145.223,2043,6493693,917,64944,1126,6428749,33.981025,31.783544,16346,1618132
172.68.51.166,167.235.145.223,641,2756185,294,21568,347,2734617,47.250046,31.111997,5545,703167
172.68.51.168,167.235.145.223,6,427,2,132,4,295,2.050628,29.924841,35,78
172.68.51.173,167.235.145.223,638,391404,422,196056,216,195348,0.203122,81.541192,19235,19165
172.68.51.174,167.235.145.223,1927,1182564,1279,591957,648,590607,0.002201,82.335279,57516,57385
172.68.51.179,167.235.145.223,176,2321765,78,7350,98,2314415,34.789063,30.491463,1928,607229
172.68.51.184,167.235.145.223,341,2478183,161,12177,180,2466006,4.770771,60.62179,1606,325428
172.68.51.185,167.235.145.223,6,427,2,132,4,295,8.272818,29.959746,35,78
172.68.51.186,167.235.145.223,906,7171003,407,30765,499,7140238,5.328892,68.183958,3609,837761
172.68.51.187,167.235.145.223,190,2901111,84,7646,106,2893465,71.285088,0.501705,121920,46138109
172.68.51.191,167.235.145.223,280,4588821,127,10773,153,4578048,22.97349,30.678662,2809,1193806
172.68.51.192,167.235.145.223,345,2310547,152,11561,193,2298986,22.935695,60.062588,1539,306212
172.68.51.193,167.235.145.223,928,4661364,406,28882,522,4632482,80.488987,1.037636,222675,35715661
172.68.51.199,167.235.145.223,306,2090815,128,9832,178,2080983,55.307768,0.225295,349124,73893623
172.68.51.200,167.235.145.223,2009,4274234,944,65474,1065,4208760,55.252968,0.680337,769900,49490296
172.68.51.202,167.235.145.223,351,6523534,174,14802,177,6508732,76.174043,0.983141,120446,52962755
172.68.51.207,167.235.145.223,2988,8988706,1360,94926,1628,8893780,36.943911,36.819557,20625,1932403
172.68.51.208,167.235.145.223,1143,4470721,519,36371,624,4434350,37.286315,36.194782,8038,980108
172.68.51.211,167.235.145.223,872,2438548,388,28000,484,2410548,16.090028,60.065569,3729,321055
172.68.51.212,167.235.145.223,643,4745202,296,21735,347,4723467,15.99241,60.499138,2874,624599
172.68.51.216,167.235.145.223,1596,3135527,665,47518,931,3088009,27.419061,38.998889,9747,633455
172.68.51.218,167.235.145.223,705,5047503,279,22317,426,5025186,0.198192,60.683736,2942,662475
172.68.62.16,167.235.145.223,334,1104323,163,12166,171,1092157,68.737668,0.512526,189898,17047439
172.68.62.17,167.235.145.223,6,427,2,132,4,295,15.298222,29.725133,35,79
172.68.62.20,167.235.145.223,6,427,2,132,4,295,8.991797,29.685891,35,79
172.68.62.25,167.235.145.223,6,427,2,132,4,295,26.352998,29.656655,35,79
172.68.62.27,167.235.145.223,6,427,2,132,4,295,2.059805,29.801363,35,79
172.68.62.30,167.235.145.223,77,2052646,41,3566,36,2049080,1.798351,60.049015,475,272987
172.68.62.38,167.235.145.223,14,7452,9,3678,5,3774,1.838559,65.962112,446,457
172.68.62.39,167.235.145.223,20,9681,10,2816,10,6865,37.781701,18.011419,1250,3049
172.68.62.43,167.235.145.223,7,493,3,198,4,295,7.938859,29.816669,53,79
172.68.62.47,167.235.145.223,365,1461951,174,12892,191,1449059,38.810739,30.525495,3378,379763
172.68.62.49,167.235.145.223,6,427,2,132,4,295,27.149759,29.685416,35,79
172.68.62.53,167.235.145.223,334,1179668,158,11836,176,1167832,44.696581,30.514947,3103,306166
172.68.62.55,167.235.145.223,11,5725,7,2882,4,2843,11.104979,62.726037,367,362
172.68.62.60,167.235.145.223,373,1471503,182,13420,191,1458083,80.517061,0.48447,221602,24077164
172.68.62.63,167.235.145.223,6,427,2,132,4,295,14.461094,29.577968,35,79
172.68.62.73,167.235.145.223,495,2061246,240,17351,255,2043895,43.845088,30.683528,4523,532896
172.68.62.75,167.235.145.223,23,12510,15,5963,8,6547,11.504003,65.658469,726,797
172.68.62.88,167.235.145.223,423,2642360,202,15497,221,2626863,14.766322,48.196855,2572,436022
172.68.62.91,167.235.145.223,30,18095,20,8832,10,9263,1.711043,69.439257,1017,1067
172.68.62.97,167.235.145.223,372,2137496,171,12797,201,2124699,37.82382,30.5488,3351,556407
172.68.62.98,167.235.145.223,366,1353557,175,12958,191,1340599,20.681415,60.219396,1721,178095
172.68.62.107,167.235.145.223,520,6073490,244,19232,276,6054258,2.498188,59.753484,2574,810564
172.68.62.109,167.235.145.223,344,1315920,163,12166,181,1303754,74.628687,0.471134,206582,22138143
172.68.62.112,167.235.145.223,411,2438385,189,13985,222,2424400,55.833048,0.52688,212344,36811418
172.68.62.116,167.235.145.223,441,2178205,204,14975,237,2163230,61.850812,0.662725,180768,26113154
172.68.62.122,167.235.145.223,352,1253164,171,12694,181,1240470,32.723729,30.494156,3330,325431
172.68.62.124,167.235.145.223,395,2458445,184,13655,211,2444790,8.454865,59.865635,1824,326703
172.68.62.126,167.235.145.223,527,2623832,255,18341,272,2605491,49.841884,30.669144,4784,679638
172.68.62.138,167.235.145.223,440,2383090,218,15899,222,2367191,19.815093,60.193917,2113,314608
172.68.62.141,167.235.145.223,49,1255161,26,2473,23,1252688,20.266376,36.343049,544,275747
172.68.62.144,167.235.145.223,6,427,2,132,4,295,21.32771,29.645759,35,79
172.68.62.150,167.235.145.223,16,7716,8,1843,8,5873,79.783911,0.221126,66676,212476
172.68.62.151,167.235.145.223,10,2392,5,1171,5,1221,19.716379,60.059583,155,162
172.68.62.158,167.235.145.223,333,1212779,160,11968,173,1200811,8.894533,60.213821,1590,159539
172.68.62.164,167.235.145.223,7,493,3,198,4,295,3.111948,29.654906,53,79
172.68.62.177,167.235.145.223,428,2496806,204,14975,224,2481831,13.806745,60.201034,1989,329805
172.68.62.181,167.235.145.223,357,1383069,168,12496,189,1370573,56.471727,0.509918,196047,21502641
172.68.62.182,167.235.145.223,33,19804,22,9612,11,10192,5.080224,68.724806,1118,1186
172.68.62.191,167.235.145.223,430,2678266,203,14909,227,2663357,73.840508,0.601115,198417,35445557
172.68.62.212,167.235.145.223,21,9748,11,2882,10,6866,55.805785,23.996036,960,2289
172.68.62.214,167.235.145.223,475,2319077,232,16823,243,2302254,25.819309,30.554328,4404,602796
172.68.62.222,167.235.145.223,443,2199422,211,15437,232,2183985,79.834745,0.533446,231506,32752855
172.68.110.5,167.235.145.223,320,6590739,158,13668,162,6577071,32.810189,21.710517,5036,2423552
172.68.110.7,167.235.145.223,6,427,2,132,4,295,18.5688,29.865061,35,79
172.68.110.9,167.235.145.223,174,2488364,100,32862,74,2455502,0.448351,78.585716,3345,249969
172.68.110.14,167.235.145.223,6,427,2,132,4,295,10.929834,29.517977,35,79
172.68.110.114,167.235.145.223,6,427,2,132,4,295,28.199856,29.721121,35,79
172.68.110.119,167.235.145.223,6,427,2,132,4,295,17.354341,29.825654,35,79
172.68.110.124,167.235.145.223,532,8256849,239,20194,293,8236655,30.136948,38.224374,4226,1723853
172.68.110.128,167.235.145.223,145,1447366,75,6293,70,1441073,30.227329,30.481842,1651,378211
172.68.110.132,167.235.145.223,6,427,2,132,4,295,16.439754,29.674178,35,79
172.68.110.134,167.235.145.223,24,15377,16,7953,8,7424,4.70187,77.011329,826,771
172.68.110.135,167.235.145.223,21,13242,14,6753,7,6489,11.69398,63.015755,857,823
172.68.110.142,167.235.145.223,96,59302,64,29656,32,29646,0.183169,80.113001,2961,2960
172.68.110.145,167.235.145.223,188,2303188,88,7363,100,2295825,74.881609,0.086273,682762,212889316
172.68.110.147,167.235.145.223,245,4309197,115,9926,130,4299271,60.153111,0.343028,231491,100266357
172.68.110.149,167.235.145.223,299,6185398,140,12292,159,6173106,0.124767,60.889824,1614,811052
172.68.110.152,167.235.145.223,162,2220111,68,6043,94,2214068,53.903716,0.08631,560120,205220067
172.68.110.153,167.235.145.223,6,427,2,132,4,295,7.356289,29.564504,35,79
172.68.110.154,167.235.145.223,202,2316144,102,8287,100,2307857,81.888118,0.083665,792398,220675981
172.68.110.163,167.235.145.223,238,4350906,107,9398,131,4341508,78.172044,0.386245,194653,89922365
172.68.110.165,167.235.145.223,290,4643751,150,12359,140,4631392,4.995572,57.417596,1721,645292
172.68.110.166,167.235.145.223,250,4490198,113,9606,137,4480592,6.122587,60.34357,1273,594010
172.68.110.170,167.235.145.223,6,427,2,132,4,295,0.897205,29.503748,35,79
172.68.110.172,167.235.145.223,243,2779915,129,10069,114,2769846,25.842035,30.165046,2670,734584
172.68.110.174,167.235.145.223,6,427,2,132,4,295,12.416433,29.99749,35,78
172.68.110.176,167.235.145.223,398,9549753,188,16552,210,9533201,18.918933,59.783598,2214,1275694
172.68.110.183,167.235.145.223,274,4877601,131,10982,143,4866619,66.165391,0.353635,248436,110093604
172.68.110.185,167.235.145.223,253,4478618,116,10115,137,4468503,11.885345,70.23249,1152,508995
172.68.110.187,167.235.145.223,539,14501278,248,21886,291,14479392,12.124862,60.375339,2899,1918583
172.68.110.190,167.235.145.223,187,2355041,113,35732,74,2319309,0.05072,79.361716,3601,233796
172.68.110.191,167.235.145.223,171,2352862,98,34482,73,2318380,0.373313,78.902403,3496,235063
172.68.110.192,167.235.145.223,7,493,3,198,4,295,24.494543,29.95728,52,78
172.68.130.132,167.235.145.223,825,9472862,340,26249,485,9446613,1.642298,73.503357,2856,1028155
172.68.130.135,167.235.145.223,590,13022476,184,28529,406,12993947,1.446264,78.065207,2923,1331599
172.68.130.136,167.235.145.223,526,14480972,226,29579,300,14451393,2.88792,78.278253,3022,1476925
172.68.130.139,167.235.145.223,731,9195442,372,28361,359,9167081,61.633621,7.449826,30455,9844075
172.68.130.141,167.235.145.223,425,9308768,146,12794,279,9295974,7.691913,49.411951,2071,1505056
172.68.130.145,167.235.145.223,258,9526760,109,10352,149,9516408,25.707131,37.594621,2202,2025057
172.68.138.37,167.235.145.223,6,427,2,132,4,295,25.780532,29.729024,35,79
172.68.138.65,167.235.145.223,6,427,2,132,4,295,19.712165,29.794137,35,79
172.68.138.117,167.235.145.223,319,2432142,148,11108,171,2421034,55.414147,0.332032,267636,58332546
172.68.138.191,167.235.145.223,6,427,2,132,4,295,7.634868,29.828195,35,79
172.68.139.62,167.235.145.223,323,2685513,162,12032,161,2673481,73.365063,0.279677,344168,76473388
172.68.171.146,167.235.145.223,159,3670268,86,18515,73,3651753,0.199806,78.078066,1897,374164
172.68.171.147,167.235.145.223,399,11300695,213,27915,186,11272780,5.010046,72.710832,3071,1240286
172.68.171.149,167.235.145.223,631,23701292,261,28561,370,23672731,0.852357,79.374022,2878,2385942
172.68.171.151,167.235.145.223,322,12105332,132,13963,190,12091369,0.294923,82.336002,1356,1174831
172.68.171.152,167.235.145.223,707,19317550,362,68244,345,19249306,1.112518,81.27637,6717,1894701
172.68.171.154,167.235.145.223,364,10991544,190,16836,174,10974708,24.325141,54.097948,2489,1622938
172.69.43.142,167.235.145.223,6,427,2,132,4,295,18.345293,29.873003,35,79
172.69.43.146,167.235.145.223,318,4597362,140,11649,178,4585713,49.203641,18.048225,5163,2032648
172.69.43.153,167.235.145.223,7,493,3,198,4,295,24.536972,29.96157,52,78
172.69.43.154,167.235.145.223,530,8254643,240,19934,290,8234709,31.520543,28.026905,5689,2350515
172.69.43.182,167.235.145.223,314,2498821,198,75962,116,2422859,0.866742,80.362951,7561,241191
172.69.43.183,167.235.145.223,374,4869074,220,78100,154,4790974,0.998667,82.095588,7610,466867
172.69.43.186,167.235.145.223,251,2525678,118,10045,133,2515633,17.594846,60.902188,1319,330448
172.69.43.190,167.235.145.223,285,2782658,130,10106,155,2772552,25.53516,30.37349,2661,730255
172.69.43.196,167.235.145.223,6,427,2,132,4,295,7.559962,29.981231,35,78
172.69.43.216,167.235.145.223,267,2073345,127,9908,140,2063437,19.529604,60.09597,1318,274685
172.69.43.222,167.235.145.223,427,7314866,204,16618,223,7298248,65.177777,5.199428,25568,11229309
172.69.43.224,167.235.145.223,296,2310291,143,10968,153,2299323,73.233594,0.244584,358747,75207634
172.69.43.233,167.235.145.223,254,2905490,117,9979,137,2895511,71.632474,0.925915,86219,25017510
172.69.43.241,167.235.145.223,513,9071014,265,22082,248,9048932,34.610355,44.041997,4011,1643691
172.69.43.242,167.235.145.223,513,320276,342,161778,171,158498,0.138163,82.128116,15758,15439
172.69.43.246,167.235.145.223,272,3254826,132,11943,140,3242883,59.621613,18.108222,5276,1432667
172.69.65.110,167.235.145.223,903,2528133,446,30924,457,2497209,11.876068,60.560592,4085,329879
172.69.65.114,167.235.145.223,7,493,3,198,4,295,7.405144,29.023969,54,81
172.69.65.133,167.235.145.223,804,2407092,380,26568,424,2380524,17.804629,60.53318,3511,314607
172.69.65.170,167.235.145.223,882,2490533,440,30528,442,2460005,65.890322,1.501945,162605,13103036
172.69.65.216,167.235.145.223,827,2465818,400,27888,427,2437930,53.818778,1.493151,149418,13061934
172.69.65.226,167.235.145.223,7,493,3,198,4,295,19.35983,29.026395,54,81
172.69.65.239,167.235.145.223,761,2163148,348,24456,413,2138692,35.879734,31.470139,6216,543675
172.69.67.4,167.235.145.223,776,2221377,366,25644,410,2195733,77.825885,1.442263,142243,12179376
172.69.67.47,167.235.145.223,821,2203262,412,28680,409,2174582,59.812274,1.478826,155150,11763828
172.69.67.53,167.235.145.223,6,427,2,132,4,295,1.292312,29.047491,36,81
172.69.67.94,167.235.145.223,797,2081155,383,26766,414,2054389,41.880717,31.496248,6798,521811
172.69.67.96,167.235.145.223,859,2721037,399,27822,460,2693215,71.845432,1.496718,148709,14395310
172.69.67.119,167.235.145.223,845,2533298,423,29406,422,2503892,29.832631,31.562125,7453,634657
172.69.67.134,167.235.145.223,799,2340439,382,26700,417,2313739,23.845917,31.631065,6752,585181
172.69.67.160,167.235.145.223,7,493,3,198,4,295,13.257737,29.074578,54,81
172.69.67.167,167.235.145.223,39,24391,26,12350,13,12041,5.510284,72.145327,1369,1335
172.69.67.172,167.235.145.223,7,493,3,198,4,295,25.29002,29.035769,54,81
172.69.67.183,167.235.145.223,864,2646051,425,29538,439,2616513,47.800908,31.541688,7491,663632
172.69.70.32,167.235.145.223,6,427,2,132,4,295,11.436543,29.267768,36,80
172.69.70.42,167.235.145.223,6,427,2,132,4,295,17.444489,29.315152,36,80
172.69.70.58,167.235.145.223,672,2072850,307,21695,365,2051155,41.16657,31.293721,5546,524362
172.69.70.78,167.235.145.223,772,2519432,371,25919,401,2493513,11.084186,60.463429,3429,329920
172.69.70.92,167.235.145.223,748,2481634,365,25523,383,2456111,68.222919,1.25635,162521,15639660
172.69.70.93,167.235.145.223,82,1191102,41,3488,41,1187614,4.319189,60.117435,464,158039
172.69.70.104,167.235.145.223,747,2460483,351,24599,396,2435884,53.150942,1.256878,156572,15504346
172.69.70.108,167.235.145.223,789,2529546,387,26975,402,2502571,29.189968,31.313889,6891,639351
172.69.70.111,167.235.145.223,207,2410685,93,6920,114,2403765,6.820153,60.11935,920,319865
172.69.70.138,167.235.145.223,6,427,2,132,4,295,5.335963,29.320281,36,80
172.69.70.181,167.235.145.223,775,2640122,389,27107,386,2613015,47.10994,31.31866,6924,667465
172.69.70.197,167.235.145.223,724,2287250,354,24797,370,2262453,8.992925,60.463585,3280,299347
172.69.70.205,167.235.145.223,794,2716723,388,27041,406,2689682,23.520519,51.840073,4172,415073
172.69.70.223,167.235.145.223,703,2334048,316,22289,387,2311759,23.080877,31.260565,5704,591610
172.69.71.10,167.235.145.223,681,2097568,308,21761,373,2075807,7.53856,60.461987,2879,274659
172.69.71.42,167.235.145.223,45,27321,30,13425,15,13896,3.994483,76.02243,1412,1462
172.69.71.44,167.235.145.223,723,2196739,355,24863,368,2171876,59.11479,1.296649,153398,13399931
172.69.71.71,167.235.145.223,748,2484701,356,24929,392,2459772,5.21549,60.466029,3298,325441
172.69.71.128,167.235.145.223,873,4335455,433,30793,440,4304662,35.134746,45.39279,5426,758651
172.69.71.161,167.235.145.223,716,2401229,330,23213,386,2378016,17.103419,60.464821,3071,314631
172.69.79.143,167.235.145.223,42,25023,28,12054,14,12969,2.274562,78.113089,1234,1328
172.69.79.174,167.235.145.223,328,2191721,144,10904,184,2180817,80.052099,0.430766,202504,40501190
172.69.79.175,167.235.145.223,330,2191852,143,10837,187,2181015,80.469808,0.41894,206941,41648255
172.69.79.179,167.235.145.223,603,4144975,272,20751,331,4124224,2.017124,60.447925,2746,545821
172.69.79.186,167.235.145.223,6,427,2,132,4,295,27.164488,29.715947,35,79
172.69.79.212,167.235.145.223,7,493,3,198,4,295,8.392371,29.994497,52,78
172.69.79.221,167.235.145.223,315,4313628,143,11586,172,4302042,62.041781,0.376537,246159,91402268
172.69.79.239,167.235.145.223,632,5219588,283,21477,349,5198111,50.035801,30.631448,5609,1357588
172.69.79.243,167.235.145.223,479,9919947,220,18165,259,9901782,26.001153,48.434928,3000,1635477
172.69.150.9,167.235.145.223,197,4316696,88,9111,109,4307585,29.231545,33.491342,2176,1028942
172.69.150.25,167.235.145.223,234,9054685,90,8694,144,9045991,7.977366,66.462009,1046,1088861
172.69.150.28,167.235.145.223,237,149411,158,76225,79,73186,0.775986,80.15146,7608,7304
172.69.150.29,167.235.145.223,240,151836,160,77718,80,74118,0.269196,81.09934,7666,7311
172.69.150.36,167.235.145.223,238,4586026,109,9563,129,4576463,22.986972,30.497755,2508,1200472
172.69.150.37,167.235.145.223,183,2299608,88,7090,95,2292518,23.022978,60.027587,944,305528
172.69.150.51,167.235.145.223,6,427,2,132,4,295,26.708748,29.97566,35,78
172.69.150.52,167.235.145.223,274,6455130,121,11238,153,6443892,58.016814,1.866341,48171,27621498
172.69.150.56,167.235.145.223,113,1303726,53,4950,60,1298776,75.355383,0.051622,767114,201274805
172.69.150.61,167.235.145.223,309,6921503,141,12544,168,6908959,28.752576,30.472993,3293,1813792
172.69.150.64,167.235.145.223,306,190901,204,96335,102,94566,0.220811,81.367444,9471,9297
172.69.150.65,167.235.145.223,303,187415,202,93776,101,93639,0.243362,81.301409,9227,9214
172.69.150.70,167.235.145.223,224,4235232,103,8863,121,4226369,34.22964,31.048318,2283,1088978
172.69.150.71,167.235.145.223,166,2123919,80,6809,86,2117110,34.273476,30.49207,1786,555451
172.69.150.89,167.235.145.223,48,1188874,23,2316,25,1186558,3.183961,60.006309,308,158191
172.69.150.90,167.235.145.223,594,375360,396,191933,198,183427,0.304528,80.871609,18986,18145
172.69.150.115,167.235.145.223,171,3248233,81,8649,90,3239584,59.170594,3.529908,19601,7342024
172.69.150.119,167.235.145.223,6,427,2,132,4,295,17.667186,29.929459,35,78
172.69.150.122,167.235.145.223,528,329199,352,165864,176,163335,0.152022,82.922842,16001,15757
172.69.150.123,167.235.145.223,102,62397,65,29640,37,32757,49.188247,32.679745,7255,8018
172.69.150.125,167.235.145.223,222,4150966,105,9259,117,4141707,55.629304,0.290682,254821,113985922
172.69.150.129,167.235.145.223,6,427,2,132,4,295,29.069032,29.527592,35,79
172.69.150.130,167.235.145.223,201,4344031,92,9375,109,4334656,71.14965,3.569831,21009,9713974
172.69.150.135,167.235.145.223,289,6094610,139,12485,150,6082125,40.984773,30.486489,3276,1596018
172.69.150.143,167.235.145.223,340,7990261,158,15409,182,7974852,61.629556,7.078127,17415,9013516
172.69.150.148,167.235.145.223,419,4790423,246,98391,173,4692032,0.709351,82.248436,9570,456376
172.69.150.149,167.235.145.223,306,190039,204,95444,102,94595,0.787239,81.887277,9324,9241
172.69.150.157,167.235.145.223,6,427,2,132,4,295,13.972799,29.982668,35,78
172.69.150.165,167.235.145.223,6,427,2,132,4,295,29.548989,29.534353,35,79
172.69.150.166,167.235.145.223,71,2460476,27,3447,44,2457029,5.210379,63.47498,434,309668
172.69.150.172,167.235.145.223,257,4491551,119,10190,138,4481361,4.958733,61.409741,1327,583798
172.69.150.173,167.235.145.223,184,2251803,89,7500,95,2244303,5.013228,60.031345,999,299084
172.69.150.174,167.235.145.223,230,4895840,109,11277,121,4884563,77.156789,3.583435,25175,10904761
172.69.150.177,167.235.145.223,45,1158572,19,2055,26,1156517,12.569592,60.007784,273,154182
172.69.150.179,167.235.145.223,119,1258946,55,5082,64,1253864,2.043987,60.025339,677,167111
172.69.150.180,167.235.145.223,123,1322494,60,5412,63,1317082,0.954176,60.027336,721,175530
172.69.150.182,167.235.145.223,435,273848,290,139487,145,134361,0.41277,82.099784,13591,13092
172.69.150.187,167.235.145.223,117,1310006,58,5280,59,1304726,66.553592,0.051077,826986,204354366
172.69.150.194,167.235.145.223,483,12427663,216,19329,267,12408334,10.428578,58.829807,2628,1687353
172.69.150.198,167.235.145.223,7,493,3,198,4,295,6.697996,29.938389,52,78
172.69.150.202,167.235.145.223,436,11633483,207,19597,229,11613886,41.149086,31.554515,4968,2944462
172.69.150.210,167.235.145.223,171,104999,114,52193,57,52806,0.712373,80.307605,5199,5260
172.69.150.211,167.235.145.223,171,106379,114,53576,57,52803,1.911737,79.754775,5374,5296
172.69.150.213,167.235.145.223,6,427,2,132,4,295,26.145508,29.998044,35,78
172.69.150.215,167.235.145.223,6,427,2,132,4,295,2.281891,29.598388,35,79
172.69.150.219,167.235.145.223,235,4754525,103,9127,132,4745398,43.637405,30.360923,2404,1250396
172.69.150.222,167.235.145.223,169,3474136,75,8253,94,3465883,35.158652,33.550955,1967,826416
172.69.150.227,167.235.145.223,471,291151,314,145713,157,145438,0.232117,81.326258,14333,14306
172.69.150.229,167.235.145.223,182,4162035,75,8253,107,4153782,53.154653,3.570294,18492,9307428
172.69.150.234,167.235.145.223,280,7121558,108,10455,172,7111103,53.009956,20.97797,3987,2711836
172.69.150.235,167.235.145.223,234,4711879,101,8613,133,4703266,53.607035,21.732119,3170,1731360
172.69.150.242,167.235.145.223,306,190890,204,96253,102,94637,0.447801,80.298838,9589,9428
172.69.150.243,167.235.145.223,303,188228,202,94592,101,93636,0.688113,79.947465,9465,9369
172.69.150.245,167.235.145.223,162,2664478,76,7332,86,2657146,11.13914,63.544392,923,334524
172.69.150.252,167.235.145.223,114,1324908,51,4818,63,1320090,4.5569,60.030101,642,175923
172.69.150.254,167.235.145.223,113,5524811,25,3328,88,5521483,18.7323,37.441089,711,1179769
172.69.151.16,167.235.145.223,318,195776,212,97439,106,98337,0.204381,79.853145,9761,9851
172.69.151.21,167.235.145.223,199,3522682,97,8731,102,3513951,31.630783,30.383112,2298,925237
172.69.151.31,167.235.145.223,210,129095,140,64184,70,64911,0.550467,82.44609,6227,6298
172.69.151.32,167.235.145.223,207,128034,138,64095,69,63939,1.080937,81.494894,6291,6276
172.69.151.47,167.235.145.223,198,122276,132,61133,66,61143,0.897908,81.760896,5981,5982
172.69.151.48,167.235.145.223,393,241553,262,120197,131,121356,0.582927,81.934151,11735,11849
172.69.151.49,167.235.145.223,234,4230140,114,9853,120,4220287,37.618012,30.28245,2602,1114912
172.69.151.59,167.235.145.223,160,2519738,78,7473,82,2512265,16.392604,64.311549,929,312511
172.69.151.71,167.235.145.223,218,4120595,98,8797,120,4111798,19.630025,60.252491,1168,545942
172.69.151.85,167.235.145.223,6,427,2,132,4,295,20.181365,29.905648,35,78
172.69.151.90,167.235.145.223,378,238803,252,122006,126,116797,0.007855,81.898132,11917,11409
172.69.151.94,167.235.145.223,213,4082692,107,10365,106,4072327,47.165212,33.571916,2469,970412
172.69.151.104,167.235.145.223,35,1272389,11,1527,24,1270862,3.561283,60.008499,203,169424
172.69.151.114,167.235.145.223,333,7308716,156,13505,177,7295211,65.208424,1.46972,73510,39709392
172.69.151.120,167.235.145.223,6,427,2,132,4,295,14.709961,29.966765,35,78
172.69.151.122,167.235.145.223,42,1348166,17,1923,25,1346243,6.564881,60.009669,256,179470
172.69.151.123,167.235.145.223,232,4428884,108,9457,124,4419427,49.630476,30.448304,2484,1161162
172.69.151.125,167.235.145.223,263,4641569,129,10542,134,4631027,1.899699,60.335597,1397,614035
172.69.151.143,167.235.145.223,195,2601856,94,7651,101,2594205,47.058574,30.460505,2009,681329
172.69.151.144,167.235.145.223,271,5190995,126,10831,145,5180164,46.996065,30.714882,2821,1349225
172.69.151.146,167.235.145.223,572,2723485,359,140262,213,2583223,0.848273,81.865045,13706,252437
172.69.151.166,167.235.145.223,6,427,2,132,4,295,20.697209,29.987197,35,78
172.69.151.168,167.235.145.223,279,6518722,123,11375,156,6507347,76.78172,1.899879,47897,27401100
172.69.151.194,167.235.145.223,6,427,2,132,4,295,2.727346,29.957226,35,78
172.69.151.205,167.235.145.223,186,115957,124,58519,62,57438,1.000138,79.636099,5878,5770
172.69.151.206,167.235.145.223,186,115636,124,58195,62,57441,1.356495,79.738186,5838,5762
172.69.151.217,167.235.145.223,12,854,4,264,8,590,23.48956,29.994713,70,157
172.69.151.220,167.235.145.223,304,7071601,132,11660,172,7059941,16.041234,60.161712,1550,938795
172.69.151.226,167.235.145.223,216,3411077,111,9300,105,3401777,82.457838,0.358002,207820,76016938
172.69.151.230,167.235.145.223,104,1282047,46,4488,58,1277559,81.23195,0.051443,697937,198675660
172.69.151.231,167.235.145.223,6,427,2,132,4,295,8.331582,29.551887,35,79
172.69.151.232,167.235.145.223,6,427,2,132,4,295,8.332645,29.578803,35,79
172.69.151.239,167.235.145.223,249,154331,166,77446,83,76885,0.699692,80.833051,7664,7609
172.69.165.12,167.235.145.223,6,427,2,132,4,295,20.936233,29.025151,36,81
172.69.165.21,167.235.145.223,617,1198451,279,19927,338,1178524,37.241795,31.651101,5036,297878
172.69.194.4,167.235.145.223,6,427,2,132,4,295,13.839281,29.715059,35,79
172.69.194.20,167.235.145.223,638,7418574,355,100013,283,7318561,1.20636,80.39885,9951,728225
172.69.194.21,167.235.145.223,199,2496261,115,45830,84,2450431,1.658939,80.702046,4543,242911
172.69.194.23,167.235.145.223,377,7447018,158,13414,219,7433604,28.612577,34.720669,3090,1712778
172.69.194.28,167.235.145.223,497,9891437,230,19175,267,9872262,11.027474,63.555324,2413,1242666
172.69.194.31,167.235.145.223,83,2315218,41,3581,42,2311637,1.515302,60.027568,477,308076
172.69.194.34,167.235.145.223,231,2470066,106,9253,125,2460813,23.609213,30.877235,2397,637573
172.69.194.47,167.235.145.223,236,1944829,111,8952,125,1935877,82.602377,0.246034,291081,62946649
172.69.194.67,167.235.145.223,7,493,3,198,4,295,20.029632,29.921862,52,78
172.69.194.78,167.235.145.223,123,77323,82,39571,41,37752,0.937502,81.303478,3893,3714
172.69.194.79,167.235.145.223,249,158667,166,81930,83,76737,0.125739,82.116001,7981,7475
172.69.194.81,167.235.145.223,416,6763382,195,16217,221,6747165,5.009562,63.587231,2040,848870
172.69.194.96,167.235.145.223,425,3698931,238,68567,187,3630364,1.5218,80.904533,6780,358977
172.69.194.97,167.235.145.223,393,243311,262,121869,131,121442,0.715026,82.379864,11834,11793
172.69.194.100,167.235.145.223,304,3889750,151,13197,153,3876553,65.625481,14.842586,7113,2089421
172.69.194.104,167.235.145.223,225,2325055,102,8989,123,2316066,35.601333,30.976354,2321,598150
172.69.194.116,167.235.145.223,6,427,2,132,4,295,0.528854,29.965586,35,78
172.69.194.124,167.235.145.223,278,2429653,130,10106,148,2419547,7.516724,60.09632,1345,322089
172.69.194.127,167.235.145.223,264,2127376,127,9908,137,2117468,37.526393,30.242306,2620,560134
172.69.194.136,167.235.145.223,135,85481,90,43783,45,41698,1.087113,78.929735,4437,4226
172.69.194.137,167.235.145.223,132,83456,88,42698,44,40758,1.257047,78.588556,4346,4149
172.69.194.144,167.235.145.223,6,427,2,132,4,295,6.536721,29.939014,35,78
172.69.194.154,167.235.145.223,252,154098,168,76206,84,77892,0.419936,81.137731,7513,7679
172.69.194.155,167.235.145.223,249,153255,166,76219,83,77036,0.487553,80.935937,7533,7614
172.69.194.168,167.235.145.223,128,2056128,61,5001,67,2051127,2.304985,60.026827,666,273361
172.69.194.174,167.235.145.223,6,427,2,132,4,295,19.671567,29.641996,35,79
172.69.194.177,167.235.145.223,7,493,3,198,4,295,8.00933,29.604408,53,79
172.69.194.180,167.235.145.223,6,427,2,132,4,295,19.771929,29.853456,35,79
172.69.194.196,167.235.145.223,147,90357,98,44964,49,45393,0.901717,80.740105,4455,4497
172.69.194.197,167.235.145.223,150,92306,100,45989,50,46317,0.387322,82.096491,4481,4513
172.69.194.202,167.235.145.223,6,427,2,132,4,295,14.033169,29.946507,35,78
172.69.194.210,167.235.145.223,270,2136827,129,10040,141,2126787,13.526505,60.092176,1336,283136
172.69.194.214,167.235.145.223,66,42023,44,21641,22,20382,0.409671,79.67307,2172,2046
172.69.194.215,167.235.145.223,66,42136,44,21757,22,20379,0.947141,81.707233,2130,1995
172.69.194.246,167.235.145.223,234,2458232,108,9385,126,2448847,77.657221,0.879589,85358,22272647
172.69.194.248,167.235.145.223,120,74243,80,37187,40,37056,0.840521,79.439489,3744,3731
172.69.194.249,167.235.145.223,120,74170,80,37116,40,37054,0.446063,79.684895,3726,3720
172.69.194.250,167.235.145.223,385,9275297,152,14056,233,9261241,41.625862,40.535041,2774,1827799
172.69.195.9,167.235.145.223,47,1188789,23,2296,24,1186493,0.474728,60.025684,306,158131
172.69.195.13,167.235.145.223,276,169927,184,84708,92,85219,0.251803,79.31441,8544,8595
172.69.195.23,167.235.145.223,262,2389404,121,9512,141,2379892,43.530054,30.391741,2503,626457
172.69.195.43,167.235.145.223,247,2186504,110,8789,137,2177715,77.170275,0.31804,221079,54778392
172.69.195.44,167.235.145.223,277,4353572,109,9622,168,4343950,76.934641,0.684336,112482,50781487
172.69.195.51,167.235.145.223,173,1000396,74,6414,99,993982,42.259336,30.491501,1682,260789
172.69.195.53,167.235.145.223,357,219974,238,109650,119,110324,0.09801,82.463643,10637,10702
172.69.195.54,167.235.145.223,174,107782,116,54028,58,53754,1.414295,80.967671,5338,5311
172.69.195.68,167.235.145.223,6,427,2,132,4,295,25.756362,29.853442,35,79
172.69.195.69,167.235.145.223,379,6877682,162,13678,217,6864004,22.607497,34.883114,3136,1574172
172.69.195.71,167.235.145.223,165,105427,110,54479,55,50948,1.0654,80.456957,5416,5065
172.69.195.72,167.235.145.223,165,105660,110,54710,55,50950,1.119098,81.850209,5347,4979
172.69.195.89,167.235.145.223,281,2321364,136,10506,145,2310858,26.366357,56.205088,1495,328917
172.69.195.131,167.235.145.223,435,267613,290,133225,145,134388,0.990349,80.142979,13298,13414
172.69.195.132,167.235.145.223,21,9944,11,3078,10,6866,79.521121,0.853884,28837,64327
172.69.195.135,167.235.145.223,289,2333922,139,10704,150,2323218,61.248871,0.237799,360102,78157368
172.69.195.151,167.235.145.223,804,10099488,350,27933,454,10071555,55.209003,16.450883,13583,4897757
172.69.195.157,167.235.145.223,7,493,3,198,4,295,12.5045,29.987805,52,78
172.69.195.169,167.235.145.223,6,427,2,132,4,295,18.630703,29.856469,35,79
172.69.195.193,167.235.145.223,114,70005,76,34805,38,35200,1.716638,79.506081,3502,3541
172.69.195.194,167.235.145.223,228,140461,152,70063,76,70398,1.357271,79.24632,7072,7106
172.69.195.224,167.235.145.223,288,2479876,137,11299,151,2468577,5.587899,60.899077,1484,324284
172.69.195.235,167.235.145.223,247,2670030,113,9715,134,2660315,11.598335,60.899546,1276,349469
172.69.195.238,167.235.145.223,222,2043018,93,7439,129,2035579,41.126625,30.241769,1967,538481
172.69.195.239,167.235.145.223,310,4072604,143,11937,167,4060667,41.041694,34.898016,2736,930864
172.69.195.247,167.235.145.223,6,427,2,132,4,295,1.653143,29.918467,35,78
172.69.195.248,167.235.145.223,168,105505,112,53629,56,51876,0.788738,80.723124,5314,5141
172.69.195.249,167.235.145.223,168,106355,112,54407,56,51948,0.50239,80.832571,5384,5141
172.69.222.29,167.235.145.223,180,1371268,87,7030,93,1364238,43.771315,30.162839,1864,361832
172.69.222.30,167.235.145.223,219,3251382,103,10083,116,3241299,59.885321,1.825174,44195,14207079
172.69.222.43,167.235.145.223,6,427,2,132,4,295,24.909133,29.903569,35,78
172.69.222.45,167.235.145.223,6,427,2,132,4,295,7.847358,29.924928,35,78
172.69.222.55,167.235.145.223,471,6468111,222,17883,249,6450228,58.807384,1.155331,123829,44664104
172.69.222.71,167.235.145.223,281,4155055,128,10973,153,4144082,54.219197,3.892293,22553,8517512
172.69.222.74,167.235.145.223,982,4297842,400,28984,582,4268858,12.788924,62.359975,3718,547640
172.69.222.76,167.235.145.223,277,3888022,134,12129,143,3875893,65.861589,5.747415,16882,5394972
172.69.222.77,167.235.145.223,7,493,3,198,4,295,21.845292,29.905211,52,78
172.69.222.91,167.235.145.223,307,4126600,151,12426,156,4114174,19.214902,62.304847,1595,528263
172.69.222.102,167.235.145.223,424,10266177,195,18555,229,10247622,41.865085,13.08601,11343,6264780
172.69.222.105,167.235.145.223,7,493,3,198,4,295,25.720639,29.975456,52,78
172.69.222.106,167.235.145.223,181,1277912,89,7162,92,1270750,37.786844,30.165022,1899,337012
172.69.222.116,167.235.145.223,390,7077372,181,14990,209,7062382,16.397372,61.287658,1956,921866
172.69.222.129,167.235.145.223,339,6553102,155,13501,184,6539601,77.19664,0.864058,125000,60547796
172.69.222.144,167.235.145.223,361,6352405,178,14995,183,6337410,34.953909,30.773969,3898,1647472
172.69.222.149,167.235.145.223,512,12589493,240,23537,272,12565956,28.916754,53.525508,3517,1878125
172.69.222.154,167.235.145.223,234,4084059,106,10281,128,4073778,47.866497,34.339682,2395,949054
172.69.222.163,167.235.145.223,6,427,2,132,4,295,19.768562,29.976681,35,78
172.69.222.164,167.235.145.223,6,427,2,132,4,295,20.873951,29.981562,35,78
172.69.222.166,167.235.145.223,1725,1081542,1150,548968,575,532574,0.21104,82.881532,52988,51405
172.69.222.167,167.235.145.223,1734,1086226,1156,550718,578,535508,0.194013,82.637321,53314,51841
172.69.222.169,167.235.145.223,933,11853647,423,34616,510,11819031,18.026072,53.911895,5136,1753829
172.69.222.172,167.235.145.223,1749,1094541,1166,554006,583,540535,0.241982,82.781468,53539,52237
172.69.222.173,167.235.145.223,1164,728107,776,368449,388,359658,0.235924,82.233239,35844,34989
172.69.222.174,167.235.145.223,383,7248544,178,14739,205,7233805,52.256267,1.498666,78677,38614634
172.69.222.178,167.235.145.223,757,472174,504,237881,253,234293,0.0638,83.040457,22917,22571
172.69.222.179,167.235.145.223,2501,3892373,1634,725188,867,3167185,0.117581,82.841096,70031,305856
172.69.222.181,167.235.145.223,14,986,6,396,8,590,5.935353,29.949975,105,157
172.69.222.182,167.235.145.223,364,6732348,172,14609,192,6717739,4.936939,62.053379,1883,866059
172.69.222.184,167.235.145.223,1251,778715,834,391653,417,387062,0.092561,82.851519,37817,37374
172.69.222.185,167.235.145.223,833,517273,555,259580,278,257693,0.333145,82.761913,25091,24909
172.69.222.204,167.235.145.223,189,1510461,89,7162,100,1503299,25.779662,30.488391,1879,394458
172.69.222.206,167.235.145.223,171,1202167,83,6997,88,1195170,57.708434,0.160321,349149,59638849
172.69.222.236,167.235.145.223,7,493,3,198,4,295,2.194851,29.722651,53,79
172.69.222.243,167.235.145.223,165,1225632,75,6238,90,1219394,49.804522,30.159692,1654,323449
172.69.223.8,167.235.145.223,6,427,2,132,4,295,26.925954,29.983673,35,78
172.69.223.14,167.235.145.223,177,5204974,90,8386,87,5196588,10.220478,59.903025,1119,694000
172.69.223.22,167.235.145.223,513,6114211,252,20275,261,6093936,41.087483,30.348831,5344,1606371
172.69.223.24,167.235.145.223,181,1362543,86,7195,95,1355348,9.765345,60.072797,958,180494
172.69.223.34,167.235.145.223,439,7957495,211,17945,228,7939550,28.948844,30.862688,4651,2058032
172.69.223.36,167.235.145.223,347,4762048,182,14472,165,4747576,67.773356,2.236471,51767,16982383
172.69.223.40,167.235.145.223,265,4167496,135,12195,130,4155301,53.876471,4.626292,21088,7185540
172.69.223.47,167.235.145.223,356,6026440,167,13674,189,6012766,25.318288,32.213153,3395,1493244
172.69.223.51,167.235.145.223,7,493,3,198,4,295,8.434573,29.937527,52,78
172.69.223.54,167.235.145.223,52,1159070,28,2716,24,1156354,14.889826,60.831192,357,152073
172.69.223.62,167.235.145.223,149,1306169,66,5875,83,1300294,69.798363,0.177953,264114,58455614
172.69.223.82,167.235.145.223,259,4347774,124,11403,135,4336371,72.206013,2.498942,36505,13882262
172.69.223.91,167.235.145.223,378,7781844,170,14468,208,7767376,47.095593,30.705635,3769,2023700
172.69.223.97,167.235.145.223,6,427,2,132,4,295,16.476519,29.708365,35,79
172.69.223.104,167.235.145.223,575,7438473,280,22378,295,7416095,10.932859,60.771252,2945,976263
172.69.223.107,167.235.145.223,319,4909346,150,12504,169,4896842,61.190256,2.895974,34541,13527309
172.69.223.110,167.235.145.223,165,1328341,80,6799,85,1321542,3.713089,60.061504,905,176025
172.69.223.114,167.235.145.223,327,4760729,161,13086,166,4747643,43.379386,32.381792,3232,1172916
172.69.223.129,167.235.145.223,6,427,2,132,4,295,28.091529,29.599304,35,79
172.69.223.133,167.235.145.223,158,1285678,77,6601,81,1279077,76.642268,0.186032,283865,55004601
172.69.223.137,167.235.145.223,305,3529810,144,11964,161,3517846,31.295321,32.20917,2971,873750
172.69.223.140,167.235.145.223,221,3477585,105,10251,116,3467334,34.149975,34.810493,2355,796848
172.69.223.141,167.235.145.223,6,427,2,132,4,295,11.948694,29.986587,35,78
172.69.223.147,167.235.145.223,339,4839875,175,14010,164,4825865,7.527377,61.689181,1816,625829
172.69.223.155,167.235.145.223,289,4589402,130,10958,159,4578444,22.849498,30.872057,2839,1186430
172.69.223.156,167.235.145.223,235,2303278,115,9110,120,2294168,22.93994,60.06202,1213,305573
172.69.223.157,167.235.145.223,543,11828696,257,21970,286,11806726,65.192065,10.94248,16062,8631846
172.69.223.161,167.235.145.223,316,4831231,149,12682,167,4818549,1.084167,61.815607,1641,623602
172.69.223.164,167.235.145.223,453,4008130,206,16881,247,3991249,11.86555,61.835356,2183,516371
172.69.223.167,167.235.145.223,48,1188854,24,2362,24,1186492,1.711043,60.014842,314,158159
172.69.223.169,167.235.145.223,169,1313536,75,6469,94,1307067,0.283576,63.637438,813,164314
172.69.223.172,167.235.145.223,109,2054885,39,3561,70,2051324,1.068314,60.016338,474,273435
172.69.223.193,167.235.145.223,226,1251006,110,8779,116,1242227,21.698078,60.058519,1169,165468
172.69.244.131,167.235.145.223,734,4938986,170,12883,564,4926103,15.195014,55.369189,1861,711746
172.69.244.137,167.235.145.223,2250,6931988,937,64977,1313,6867011,21.204257,37.330522,13924,1471613
172.69.244.138,167.235.145.223,462,4420557,119,15278,343,4405279,2.759668,61.573261,1985,572362
172.69.244.144,167.235.145.223,344,2070251,87,6584,257,2063667,3.201451,60.210564,874,274193
172.69.244.145,167.235.145.223,7,493,3,198,4,295,21.506296,29.906824,52,78
172.69.244.151,167.235.145.223,638,11662071,280,26658,358,11635413,3.627942,78.714107,2709,1182549
172.69.244.155,167.235.145.223,27,16743,18,8406,9,8337,9.636426,72.23098,931,923
172.69.244.164,167.235.145.223,7,493,3,198,4,295,15.834566,29.573091,53,79
172.69.244.165,167.235.145.223,1685,2775537,758,51500,927,2724037,76.112426,2.815049,146356,7741355
172.70.34.25,167.235.145.223,23,11642,12,3852,11,7790,18.228687,56.06503,549,1111
172.70.34.41,167.235.145.223,628,2473867,273,19604,355,2454263,68.714389,1.136417,138005,17277200
172.70.34.74,167.235.145.223,596,2067986,268,19274,328,2048712,44.638896,31.16847,4947,525842
172.70.34.80,167.235.145.223,598,2092243,268,19274,330,2072969,2.79995,60.418618,2552,274480
172.70.34.81,167.235.145.223,645,2212829,300,21386,345,2191443,80.619027,1.130641,151319,15505844
172.70.34.89,167.235.145.223,7,493,3,198,4,295,3.730187,29.29139,54,80
172.70.34.109,167.235.145.223,645,2453904,294,20990,351,2432914,56.814343,1.132021,148336,17193419
172.70.34.118,167.235.145.223,673,2708859,312,22178,361,2686681,74.616872,1.133536,156522,18961416
172.70.34.154,167.235.145.223,675,2193724,324,22970,351,2170754,62.703586,1.135292,161861,15296533
172.70.34.175,167.235.145.223,728,4636626,320,23641,408,4612985,8.655228,72.027155,2625,512360
172.70.34.185,167.235.145.223,6,427,2,132,4,295,27.743732,29.240714,36,80
172.70.34.201,167.235.145.223,1273,2868347,568,41694,705,2826653,50.614766,31.463953,10601,718702
172.70.34.210,167.235.145.223,6,427,2,132,4,295,15.987996,29.259654,36,80
172.70.34.216,167.235.145.223,127,2116267,58,4763,69,2111504,21.763454,47.423013,803,356199
172.70.34.254,167.235.145.223,42,27643,28,14672,14,12971,2.339101,78.141851,1502,1327
172.70.35.27,167.235.145.223,630,2519206,266,19142,364,2500064,32.729221,31.249776,4900,640020
172.70.35.35,167.235.145.223,663,2512391,301,21452,362,2490939,14.732321,60.422988,2840,329800
172.70.35.90,167.235.145.223,7,493,3,198,4,295,9.898628,29.251185,54,80
172.70.35.91,167.235.145.223,594,2327007,248,17954,346,2309053,26.578648,31.160408,4609,592817
172.70.46.3,167.235.145.223,215,2328929,103,8188,112,2320741,2.243274,60.050693,1090,309170
172.70.46.5,167.235.145.223,348,7246220,159,13440,189,7232780,9.597185,44.733819,2403,1293478
172.70.46.6,167.235.145.223,7,493,3,198,4,295,17.258545,29.996552,52,78
172.70.46.7,167.235.145.223,188,2780562,87,7921,101,2772641,54.344556,1.533241,41329,14466824
172.70.46.10,167.235.145.223,353,7445394,162,13638,191,7431756,29.089896,31.048845,3513,1914855
172.70.46.12,167.235.145.223,243,2479897,146,55379,97,2424518,0.301577,78.921378,5613,245765
172.70.46.19,167.235.145.223,202,2316042,95,7723,107,2308319,81.671505,0.115415,535320,160001316
172.70.46.20,167.235.145.223,117,74926,78,38725,39,36201,1.007365,80.546303,3846,3595
172.70.46.21,167.235.145.223,114,72383,76,37181,38,35202,2.151644,79.36835,3747,3548
172.70.46.22,167.235.145.223,36,22680,24,11562,12,11118,7.733486,75.287314,1228,1181
172.70.46.23,167.235.145.223,107,2335621,60,14003,47,2321618,1.728197,81.185062,1379,228772
172.70.46.26,167.235.145.223,361,7310349,173,14411,188,7295938,65.179503,1.372233,84014,42534689
172.70.46.33,167.235.145.223,380,8007668,177,14675,203,7992993,71.218908,1.451439,80885,44055550
172.70.46.39,167.235.145.223,222,6862144,113,9753,109,6852391,23.040773,31.143156,2505,1760230
172.70.46.40,167.235.145.223,192,2901243,87,7844,105,2893399,72.380871,0.717757,87427,32249343
172.70.46.46,167.235.145.223,6,427,2,132,4,295,11.454053,29.875855,35,78
172.70.46.50,167.235.145.223,218,4854571,118,30858,100,4823713,2.219383,78.09447,3161,494141
172.70.46.51,167.235.145.223,305,2531213,168,35555,137,2495658,1.756923,79.880345,3560,249939
172.70.46.55,167.235.145.223,208,2385767,98,7921,110,2377846,69.641637,0.158716,399254,119854129
172.70.46.59,167.235.145.223,292,6094443,127,11328,165,6083115,41.075948,31.451997,2881,1547275
172.70.46.64,167.235.145.223,186,2082964,86,7129,100,2075835,57.616617,0.114003,500267,145668798
172.70.46.84,167.235.145.223,78,46670,52,22584,26,24086,3.390837,78.28412,2307,2461
172.70.46.85,167.235.145.223,142,2416870,80,25088,62,2391782,0.561535,80.923559,2480,236448
172.70.46.90,167.235.145.223,6,427,2,132,4,295,7.861858,29.981126,35,78
172.70.46.104,167.235.145.223,280,9222112,131,12452,149,9209660,5.224094,73.705726,1351,999614
172.70.46.105,167.235.145.223,7,493,3,198,4,295,5.192174,29.902603,52,78
172.70.46.108,167.235.145.223,126,2274158,72,20727,54,2253431,0.987969,79.066488,2097,228003
172.70.46.109,167.235.145.223,172,4231764,89,22480,83,4209284,1.358288,81.681917,2201,412261
172.70.46.120,167.235.145.223,67,2054937,31,2848,36,2052089,21.550471,60.014474,379,273545
172.70.46.140,167.235.145.223,126,78524,84,39606,42,38918,1.081634,80.461657,3937,3869
172.70.46.141,167.235.145.223,126,77393,84,38486,42,38907,0.532985,80.286529,3834,3876
172.70.46.142,167.235.145.223,6,427,2,132,4,295,1.673382,29.995865,35,78
172.70.46.148,167.235.145.223,183,2882669,80,7450,103,2875219,30.309076,30.906261,1928,744242
172.70.46.153,167.235.145.223,181,2665587,79,7384,102,2658203,12.304262,60.833745,971,349569
172.70.46.154,167.235.145.223,6,427,2,132,4,295,21.839698,29.707243,35,79
172.70.46.158,167.235.145.223,265,5285122,125,11222,140,5273900,18.31681,39.471205,2274,1068910
172.70.46.161,167.235.145.223,191,2423838,77,6535,114,2417303,9.553857,60.053135,870,322021
172.70.46.165,167.235.145.223,267,166090,178,83543,89,82547,1.587927,80.576598,8294,8195
172.70.46.167,167.235.145.223,213,128528,142,62759,71,65769,0.016918,79.455801,6318,6621
172.70.46.187,167.235.145.223,135,1142457,64,5678,71,1136779,82.388129,0.109376,415301,83146503
172.70.46.195,167.235.145.223,215,2595500,107,9241,108,2586259,66.327008,1.568193,47142,13193575
172.70.46.197,167.235.145.223,304,2420738,196,67770,108,2352968,0.647271,81.112794,6684,232068
172.70.46.202,167.235.145.223,6,427,2,132,4,295,19.849229,29.993684,35,78
172.70.46.206,167.235.145.223,346,6459578,167,13970,179,6445608,58.211265,2.25209,49625,22896449
172.70.46.211,167.235.145.223,206,2474385,100,8779,106,2465606,6.304327,61.539156,1141,320525
172.70.46.212,167.235.145.223,243,1338170,156,67665,87,1270505,0.071712,82.727729,6543,122861
172.70.46.213,167.235.145.223,140,1076322,91,34212,49,1042110,0.289494,80.958629,3380,102977
172.70.46.223,167.235.145.223,180,1769122,88,7198,92,1761924,32.308212,30.350093,1897,464426
172.70.46.229,167.235.145.223,171,2466019,78,7318,93,2458701,24.326249,30.930154,1892,635936
172.70.46.235,167.235.145.223,173,2454051,81,7448,92,2446603,77.890234,0.470759,126570,41577163
172.70.46.237,167.235.145.223,604,7741321,284,23504,320,7717817,35.028157,31.338667,5999,1970171
172.70.46.239,167.235.145.223,478,7827432,219,18110,259,7809322,16.268225,61.570842,2353,1014677
172.70.46.245,167.235.145.223,196,2131870,92,7525,104,2124345,15.549786,60.052162,1002,282999
172.70.46.250,167.235.145.223,135,84305,90,42574,45,41731,0.839588,81.534244,4177,4094
172.70.47.13,167.235.145.223,63,37909,42,18451,21,19458,1.242831,78.025213,1891,1995
172.70.47.18,167.235.145.223,210,125126,140,60285,70,64841,0.263324,78.696619,6128,6591
172.70.47.23,167.235.145.223,351,7779760,148,12714,203,7767046,47.019759,31.601678,3218,1966236
172.70.47.27,167.235.145.223,132,4467940,58,6820,74,4461120,15.747121,46.125924,1182,773728
172.70.47.38,167.235.145.223,190,2122489,90,7463,100,2115026,39.509144,30.119899,1982,561761
172.70.47.39,167.235.145.223,206,2222850,100,7990,106,2214860,50.334546,30.116382,2122,588346
172.70.47.51,167.235.145.223,87,53576,58,26713,29,26863,1.062267,79.679678,2682,2697
172.70.47.52,167.235.145.223,87,52325,58,25458,29,26867,1.626926,80.209298,2539,2679
172.70.47.56,167.235.145.223,93,58399,62,29684,31,28715,1.598429,78.168109,3037,2938
172.70.85.4,167.235.145.223,256,2187072,116,9128,140,2177944,25.194706,52.272942,1396,333318
172.70.85.23,167.235.145.223,217,1247208,104,8187,113,1239021,14.644291,60.101228,1089,164924
172.70.85.28,167.235.145.223,253,2256203,108,8600,145,2247603,5.228536,60.103004,1144,299166
172.70.85.30,167.235.145.223,266,2305245,127,9854,139,2295391,23.214452,30.247467,2606,607096
172.70.85.60,167.235.145.223,6,427,2,132,4,295,19.197956,29.963065,35,78
172.70.85.62,167.235.145.223,223,1344034,106,8319,117,1335715,21.021872,60.101689,1107,177794
172.70.85.83,167.235.145.223,7,493,3,198,4,295,8.669103,29.952406,52,78
172.70.85.107,167.235.145.223,6,427,2,132,4,295,0.41937,29.866278,35,79
172.70.85.112,167.235.145.223,217,1373745,106,8319,111,1365426,56.843601,0.228383,291405,47829339
172.70.85.114,167.235.145.223,7,493,3,198,4,295,7.241347,29.91841,52,78
172.70.85.124,167.235.145.223,269,2166814,129,9986,140,2156828,59.236064,0.287198,278163,60079192
172.70.85.136,167.235.145.223,193,1305869,85,6933,108,1298936,74.994715,0.214208,258925,48511204
172.70.85.142,167.235.145.223,240,2358928,115,9585,125,2349343,8.759355,66.278919,1156,283570
172.70.85.157,167.235.145.223,10,2289,5,1067,5,1222,1.063205,60.022361,142,162
172.70.85.165,167.235.145.223,208,1400281,98,7791,110,1392490,62.731161,0.225225,276736,49461294
172.70.85.167,167.235.145.223,296,2488055,143,10910,153,2477145,11.228055,60.097868,1452,329748
172.70.85.203,167.235.145.223,264,2371436,116,9128,148,2362308,17.212241,60.096426,1215,314469
172.70.85.209,167.235.145.223,61,2051486,24,2340,37,2049146,1.171336,60.025574,311,273103
172.70.85.229,167.235.145.223,42,26271,28,13300,14,12971,0.228387,78.049762,1363,1329
172.70.85.231,167.235.145.223,217,1346646,102,8055,115,1338591,2.867177,60.100469,1072,178180
172.70.85.239,167.235.145.223,260,2606171,110,8732,150,2597439,47.220031,30.48886,2291,681544
172.70.85.241,167.235.145.223,222,1461452,106,8319,116,1453133,80.886167,0.225309,295381,51596092
172.70.85.244,167.235.145.223,252,2129538,115,9062,137,2120476,35.220734,30.250816,2396,560771
172.70.85.247,167.235.145.223,209,1270771,100,7923,109,1262848,26.911091,30.263418,2094,333828
172.70.86.22,167.235.145.223,71,2028088,35,3131,36,2024957,27.199146,44.512101,562,363938
172.70.86.28,167.235.145.223,266,2449861,122,9524,144,2440337,65.235381,0.237238,321162,82291605
172.70.86.31,167.235.145.223,157,2461062,91,27351,66,2433711,0.305105,79.978504,2735,243436
172.70.86.55,167.235.145.223,6,427,2,132,4,295,21.028528,29.682981,35,79
172.70.86.58,167.235.145.223,214,1243971,103,8121,111,1235850,32.805043,30.226645,2149,327088
172.70.86.73,167.235.145.223,6,427,2,132,4,295,13.190458,29.97715,35,78
172.70.86.91,167.235.145.223,6,427,2,132,4,295,6.437282,29.873201,35,79
172.70.86.127,167.235.145.223,42,26716,28,13748,14,12968,1.16913,78.01022,1409,1329
172.70.86.130,167.235.145.223,39,24184,26,12142,13,12042,5.161065,72.029769,1348,1337
172.70.86.131,167.235.145.223,292,2683599,141,10778,151,2672821,71.33454,0.234609,367522,91141294
172.70.86.156,167.235.145.223,196,1095130,90,7263,106,1087867,68.61794,0.227338,255584,38281923
172.70.86.159,167.235.145.223,226,1452692,109,8517,117,1444175,38.688925,30.241385,2253,382039
172.70.86.177,167.235.145.223,287,2496454,137,10514,150,2485940,29.230449,30.261199,2779,657195
172.70.90.5,167.235.145.223,42,26908,28,13930,14,12978,3.771441,78.088079,1427,1329
172.70.90.15,167.235.145.223,247,1773687,122,9585,125,1764102,33.872387,30.231245,2536,466828
172.70.90.31,167.235.145.223,252,2126622,113,8991,139,2117631,4.23372,66.049139,1089,256491
172.70.90.35,167.235.145.223,252,2045226,115,9119,137,2036107,43.470913,30.398014,2399,535852
172.70.90.42,167.235.145.223,79,2209475,41,3588,38,2205887,25.708583,56.264119,510,313647
172.70.90.111,167.235.145.223,42,26843,28,13874,14,12969,1.412616,78.028962,1422,1329
172.70.90.116,167.235.145.223,254,2388883,112,8925,142,2379958,69.880114,0.279179,255749,68198768
172.70.90.129,167.235.145.223,346,4897526,158,12839,188,4884687,49.47134,26.437203,3885,1478125
172.70.90.141,167.235.145.223,250,2087268,117,9255,133,2078013,57.874962,0.259753,285040,63999661
172.70.90.144,167.235.145.223,7,493,3,198,4,295,16.237212,29.661542,53,79
172.70.90.151,167.235.145.223,294,2487980,144,11033,150,2476947,13.454473,60.091519,1468,329756
172.70.90.169,167.235.145.223,7,493,3,198,4,295,7.715291,29.839133,53,79
172.70.90.173,167.235.145.223,247,2186504,113,8987,134,2177517,79.465668,0.243034,295826,71677773
172.70.90.195,167.235.145.223,287,2451303,139,10703,148,2440600,67.469387,0.251022,341101,77781230
172.70.90.207,167.235.145.223,6,427,2,132,4,295,19.719537,29.846099,35,79
172.70.90.219,167.235.145.223,329,4384148,154,12575,175,4371573,1.457239,62.386824,1612,560576
172.70.90.248,167.235.145.223,326,4703351,150,12315,176,4691036,45.878506,18.031878,5463,2081219
172.70.90.249,167.235.145.223,6,427,2,132,4,295,10.275173,29.610686,35,79
172.70.90.253,167.235.145.223,6,427,2,132,4,295,1.712612,29.840799,35,79
172.70.91.3,167.235.145.223,333,4782157,152,12439,181,4769718,19.462913,36.056759,2759,1058268
172.70.91.5,167.235.145.223,262,2166409,123,9647,139,2156762,61.472695,0.250149,308520,68975274
172.70.91.56,167.235.145.223,264,2305169,123,9647,141,2295522,25.464972,30.246489,2551,607150
172.70.91.90,167.235.145.223,284,2782599,126,9849,158,2772750,27.868636,30.345853,2596,730973
172.70.91.95,167.235.145.223,281,2682930,130,10109,151,2672821,73.491942,0.246046,328686,86904757
172.70.91.98,167.235.145.223,270,2320610,129,10047,141,2310563,81.887484,0.237324,338676,77887209
172.70.91.99,167.235.145.223,278,2257910,131,10175,147,2247735,7.455188,60.096477,1354,299216
172.70.91.144,167.235.145.223,71,2410862,28,2730,43,2408132,9.836691,60.024229,363,320954
172.70.91.148,167.235.145.223,274,2137098,131,10179,143,2126919,15.850898,60.102341,1354,283106
172.70.91.165,167.235.145.223,6,427,2,132,4,295,13.749182,29.820535,35,79
172.70.91.188,167.235.145.223,251,2072296,113,8991,138,2063305,21.857331,60.093314,1196,274680
172.70.91.203,167.235.145.223,293,2496907,140,10769,153,2486138,31.478915,30.50023,2824,652096
172.70.91.213,167.235.145.223,6,427,2,132,4,295,22.056781,29.845807,35,79
172.70.91.233,167.235.145.223,6,427,2,132,4,295,28.135242,29.778747,35,79
172.70.91.240,167.235.145.223,265,2130453,131,10175,134,2120278,37.471176,30.310118,2685,559622
172.70.92.137,167.235.145.223,635,1271900,292,20738,343,1251162,24.836925,31.568371,5255,317067
172.70.92.140,167.235.145.223,681,1338220,319,22520,362,1315700,66.89143,1.66511,108197,6321264
172.70.92.151,167.235.145.223,771,2643981,321,23089,450,2620892,41.444453,12.325917,14985,1701060
172.70.92.153,167.235.145.223,168,2474276,51,3992,117,2470284,12.530666,60.159111,530,328500
172.70.92.169,167.235.145.223,6,427,2,132,4,295,2.662238,28.951574,36,81
172.70.92.184,167.235.145.223,6,427,2,132,4,295,8.668153,28.949155,36,81
172.70.92.194,167.235.145.223,7,493,3,198,4,295,27.226356,28.675641,55,82
172.70.92.197,167.235.145.223,7,493,3,198,4,295,26.371936,28.841675,54,81
172.70.92.198,167.235.145.223,660,1234419,315,22256,345,1212163,0.854013,60.68562,2933,159795
172.70.92.238,167.235.145.223,6,427,2,132,4,295,20.478786,29.00422,36,81
172.70.92.244,167.235.145.223,603,1121946,291,20483,312,1101463,59.495058,1.555479,105346,5664945
172.70.92.252,167.235.145.223,6,427,2,132,4,295,20.296516,28.858313,36,81
172.70.93.31,167.235.145.223,693,1302889,334,23510,359,1279379,18.859136,60.664572,3100,168715
172.70.93.32,167.235.145.223,866,2109622,410,28337,456,2081285,0.523475,60.641892,3738,274567
172.70.93.53,167.235.145.223,692,1483402,314,22001,378,1461401,29.425899,31.633986,5563,369577
172.70.147.34,167.235.145.223,6,427,2,132,4,295,8.516951,28.744888,36,82
172.70.147.52,167.235.145.223,6,427,2,132,4,295,14.329611,28.839892,36,81
172.70.147.74,167.235.145.223,7,493,3,198,4,295,14.444665,29.014351,54,81
172.70.147.78,167.235.145.223,6,427,2,132,4,295,2.2153,28.896766,36,81
172.70.147.96,167.235.145.223,941,2301416,439,30251,502,2271165,6.547294,60.741384,3984,299125
172.70.147.107,167.235.145.223,42,26215,28,13244,14,12971,2.217933,78.159759,1355,1327
172.70.147.128,167.235.145.223,642,1266346,303,21464,339,1244882,78.904089,1.579056,108743,6306968
172.70.147.137,167.235.145.223,712,1467871,349,24500,363,1443371,72.823168,1.568466,124962,7361949
172.70.147.138,167.235.145.223,705,1375989,333,23444,372,1352545,12.838748,60.682869,3090,178309
172.70.147.149,167.235.145.223,554,1269593,193,14204,361,1255389,6.822017,60.723287,1871,165391
172.70.147.153,167.235.145.223,42,25961,28,12992,14,12969,0.37833,78.185183,1329,1327
172.70.147.167,167.235.145.223,740,1408217,355,24707,385,1383510,47.462541,31.81842,6211,347851
172.70.147.195,167.235.145.223,46,25054,31,11151,15,13903,0.111366,82.662643,1079,1345
172.70.210.3,167.235.145.223,623,1123474,298,21122,325,1102352,4.915311,58.983413,2864,149513
172.70.210.23,167.235.145.223,141,1237187,42,3575,99,1233612,11.987315,60.162817,475,164036
172.70.210.70,167.235.145.223,746,1496167,358,25082,388,1471085,74.300207,1.594443,125847,7381060
172.70.210.88,167.235.145.223,6,427,2,132,4,295,10.961923,28.974676,36,81
172.70.210.164,167.235.145.223,680,1256780,324,22838,356,1233942,44.304579,31.617412,5778,312218
172.70.210.188,167.235.145.223,7,493,3,198,4,295,27.271032,29.783488,53,79
172.70.210.200,167.235.145.223,640,1299379,297,21056,343,1278323,16.94306,60.630971,2778,168669
172.70.211.25,167.235.145.223,719,1479569,344,24158,375,1455411,28.923292,31.681614,6100,367509
172.70.211.58,167.235.145.223,655,1336492,304,21518,351,1314974,68.305795,1.556676,110584,6757855
172.70.211.77,167.235.145.223,689,1374920,329,23168,360,1351752,13.138879,60.627632,3057,178367
172.70.211.94,167.235.145.223,659,1234341,319,22508,340,1211833,9.681384,60.65816,2968,159824
172.70.211.103,167.235.145.223,658,1201098,319,22508,339,1178590,34.957664,31.620449,5694,298184
172.70.211.121,167.235.145.223,706,1406150,337,23696,369,1382454,50.31028,31.624814,5994,349713
172.70.211.123,167.235.145.223,664,1267786,317,22376,347,1245410,80.286956,1.591882,112450,6258805
172.70.211.140,167.235.145.223,705,1433214,345,24224,360,1408990,56.386643,1.575828,122977,7153014
172.70.211.151,167.235.145.223,664,1273801,314,22178,350,1251623,22.951198,31.652911,5605,316336
172.70.211.166,167.235.145.223,709,1379249,333,23432,376,1355817,6.639338,60.659177,3090,178811
172.70.211.206,167.235.145.223,44,25933,29,12890,15,13043,0.131984,79.94269,1289,1305
172.70.211.220,167.235.145.223,6,427,2,132,4,295,16.904778,29.01066,36,81
172.70.235.130,167.235.145.223,593,2411069,332,23257,261,2387812,70.556614,0.653697,284621,29222248
172.70.235.132,167.235.145.223,253,8854047,114,10300,139,8843747,10.647203,71.978562,1144,982931
172.70.235.135,167.235.145.223,679,4873925,358,25667,321,4848258,28.540485,30.093176,6823,1288865
172.70.235.137,167.235.145.223,168,4687411,92,7460,76,4679951,29.254382,35.730396,1670,1047836
172.70.235.138,167.235.145.223,151,5980322,57,5844,94,5974478,16.548125,54.424184,859,878209
172.70.235.140,167.235.145.223,96,2337370,46,13180,50,2324190,4.450836,78.079692,1350,238135
172.70.235.142,167.235.145.223,74,2410872,33,2872,41,2408000,10.539697,60.064051,382,320724
172.70.242.10,167.235.145.223,242,5539725,116,10662,126,5529063,22.921486,36.266127,2351,1219664
172.70.242.15,167.235.145.223,152,2519060,69,6728,83,2512332,17.259622,61.55917,874,326493
172.70.242.19,167.235.145.223,6,427,2,132,4,295,10.039305,29.758132,35,79
172.70.242.21,167.235.145.223,6,427,2,132,4,295,0.015805,29.879046,35,78
172.70.242.28,167.235.145.223,278,6025659,139,12972,139,6012687,57.170766,22.911573,4529,2099441
172.70.242.38,167.235.145.223,239,4121860,118,9995,121,4111865,19.074075,63.208437,1265,520419
172.70.242.50,167.235.145.223,7,493,3,198,4,295,4.122191,29.990433,52,78
172.70.242.53,167.235.145.223,6,427,2,132,4,295,15.950379,29.992049,35,78
172.70.242.56,167.235.145.223,150,2470750,69,6794,81,2463956,7.145941,64.14853,847,307281
172.70.242.60,167.235.145.223,7,493,3,198,4,295,23.169926,28.770872,55,82
172.70.242.75,167.235.145.223,6,427,2,132,4,295,23.543844,29.716083,35,79
172.70.242.78,167.235.145.223,253,4876159,118,10068,135,4866091,65.186322,2.068578,38936,18819076
172.70.242.92,167.235.145.223,247,4755196,112,9599,135,4745597,67.078601,4.445727,17273,8539610
172.70.242.104,167.235.145.223,6,427,2,132,4,295,29.19976,29.922605,35,78
172.70.242.123,167.235.145.223,6,427,2,132,4,295,8.357342,29.845178,35,79
172.70.242.132,167.235.145.223,258,4834277,121,10193,137,4824084,7.090146,62.793323,1298,614598
172.70.242.137,167.235.145.223,113,69274,73,32899,40,36375,0.637736,78.984047,3332,3684
172.70.242.139,167.235.145.223,42,26829,28,13860,14,12969,1.227932,78.10415,1419,1328
172.70.242.140,167.235.145.223,210,125895,140,61049,70,64846,0.943113,80.082323,6098,6477
172.70.242.142,167.235.145.223,132,84463,88,43692,44,40771,0.314554,81.77315,4274,3988
172.70.242.145,167.235.145.223,45,25552,30,11659,15,13893,1.069096,78.10068,1194,1423
172.70.242.146,167.235.145.223,84,50514,56,24576,28,25938,1.533959,78.165372,2515,2654
172.70.242.147,167.235.145.223,87,55055,58,28194,29,26861,0.905625,80.708991,2794,2662
172.70.242.148,167.235.145.223,96,58627,64,28986,32,29641,1.504235,79.025624,2934,3000
172.70.242.153,167.235.145.223,142,1252373,89,34739,53,1217634,1.324654,78.740873,3529,123710
172.70.242.154,167.235.145.223,210,4267746,116,29568,94,4238178,1.172618,79.190875,2987,428148
172.70.242.161,167.235.145.223,168,6561992,65,6879,103,6555113,10.008574,63.248776,870,829121
172.70.242.164,167.235.145.223,159,2591852,78,7375,81,2584477,68.705897,0.557752,105781,37069909
172.70.242.179,167.235.145.223,6,427,2,132,4,295,17.244558,29.791144,35,79
172.70.242.183,167.235.145.223,7,493,3,198,4,295,21.9674,29.987413,52,78
172.70.242.188,167.235.145.223,6,427,2,132,4,295,16.291112,29.582059,35,79
172.70.242.193,167.235.145.223,148,2452527,70,6847,78,2445680,80.139619,1.102564,49680,17745400
172.70.242.195,167.235.145.223,305,5800219,153,13265,152,5786954,1.065307,75.942336,1397,609615
172.70.242.207,167.235.145.223,124,1325727,62,5703,62,1320024,4.924689,60.031748,759,175910
172.70.242.212,167.235.145.223,46,1348589,21,2346,25,1346243,10.918264,60.008158,312,179474
172.70.242.219,167.235.145.223,130,1340936,66,5711,64,1335225,5.332592,60.028839,761,177944
172.70.242.227,167.235.145.223,156,2465073,78,7361,78,2457712,23.260402,43.047025,1367,456749
172.70.243.13,167.235.145.223,261,2183385,148,36218,113,2147167,4.806475,76.292297,3797,225151
172.70.243.14,167.235.145.223,153,2175576,89,31628,64,2143948,1.197827,79.889464,3167,214691
172.70.243.15,167.235.145.223,105,64567,70,31996,35,32571,1.09811,79.154539,3233,3291
172.70.243.16,167.235.145.223,105,65351,70,32926,35,32425,1.163647,79.501593,3313,3262
172.70.243.17,167.235.145.223,153,1062451,97,41291,56,1021160,1.899397,79.945884,4131,102185
172.70.243.19,167.235.145.223,86,48646,51,19223,35,29423,3.581757,76.50368,2010,3076
172.70.243.20,167.235.145.223,45,25274,27,10064,18,15210,3.584325,76.513899,1052,1590
172.70.243.21,167.235.145.223,72,45756,48,23524,24,22232,1.629486,79.341471,2371,2241
172.70.243.22,167.235.145.223,69,44119,46,22814,23,21305,1.567338,78.177527,2334,2180
172.70.243.24,167.235.145.223,87,51741,58,25100,29,26641,2.576088,74.911639,2680,2845
172.70.243.31,167.235.145.223,329,7492320,149,13074,180,7479246,47.168984,34.038575,3072,1757828
172.70.243.39,167.235.145.223,257,4352103,127,10662,130,4341441,77.18583,2.062966,41346,16835724
172.70.243.43,167.235.145.223,394,11612733,155,15076,239,11597657,23.49347,53.549508,2252,1732625
172.70.243.48,167.235.145.223,159,2579798,76,7190,83,2572608,5.577496,63.66409,903,323272
172.70.243.49,167.235.145.223,141,2319329,64,6300,77,2313029,37.022266,34.682232,1453,533536
172.70.243.56,167.235.145.223,216,4234919,96,8616,120,4226303,35.16261,32.274192,2135,1047599
172.70.243.60,167.235.145.223,185,6972584,75,8041,110,6964543,1.259396,69.733727,922,798987
172.70.243.66,167.235.145.223,252,4966508,115,9870,137,4956638,29.167981,32.08785,2460,1235766
172.70.243.71,167.235.145.223,165,2899617,72,6979,93,2892638,5.420477,69.749028,800,331776
172.70.243.88,167.235.145.223,162,2724649,78,7390,84,2717259,51.14938,8.30378,7119,2617852
172.70.243.95,167.235.145.223,6,427,2,132,4,295,3.598907,29.976621,35,78
172.70.243.97,167.235.145.223,235,4067435,114,9804,121,4057631,41.170088,32.111932,2442,1010871
172.70.243.99,167.235.145.223,191,3522032,89,8081,102,3513951,31.071316,33.450536,1932,840393
172.70.243.102,167.235.145.223,343,6813806,172,14572,171,6799234,17.159789,62.055813,1878,876531
172.70.243.103,167.235.145.223,7,493,3,198,4,295,28.030227,29.789189,53,79
172.70.243.130,167.235.145.223,6,427,2,132,4,295,5.415373,29.542959,35,79
172.70.243.139,167.235.145.223,111,1219128,54,4919,57,1214209,45.204277,30.244363,1301,321172
172.70.243.146,167.235.145.223,235,7405703,114,10093,121,7395610,11.093265,62.105246,1300,952655
172.70.243.156,167.235.145.223,262,4775080,134,11124,128,4763956,53.177735,2.162451,41153,17624282
172.70.243.179,167.235.145.223,312,6510897,129,11397,183,6499500,25.081937,33.36115,2732,1558579
172.70.243.181,167.235.145.223,6,427,2,132,4,295,3.99499,29.934427,35,78
172.70.243.198,167.235.145.223,246,4429687,118,9995,128,4419692,49.076255,33.965184,2354,1040993
172.70.243.200,167.235.145.223,132,2168196,62,6319,70,2161877,62.267472,1.123722,44986,15390831
172.70.243.205,167.235.145.223,223,4590889,94,8411,129,4582478,73.080217,4.72431,14242,7759826
172.70.243.210,167.235.145.223,227,4332382,102,9147,125,4323235,55.086173,4.244836,17238,8147754
172.70.243.226,167.235.145.223,481,10097608,221,19653,260,10077955,5.154746,72.672702,2163,1109407
172.70.246.2,167.235.145.223,187,2327212,91,7527,96,2319685,3.507124,60.031205,1003,309130
172.70.246.17,167.235.145.223,6,427,2,132,4,295,8.923097,29.96525,35,78
172.70.246.24,167.235.145.223,48,30399,32,15534,16,14865,1.189554,78.478681,1583,1515
172.70.246.25,167.235.145.223,48,30243,32,15422,16,14821,1.654199,78.989022,1561,1501
172.70.246.37,167.235.145.223,82,2372393,43,3717,39,2368676,26.936354,48.96024,607,387036
172.70.246.41,167.235.145.223,256,4719840,120,10300,136,4709540,15.880238,63.095403,1305,597132
172.70.246.46,167.235.145.223,247,4586616,116,10020,131,4576596,23.188476,31.814038,2519,1150836
172.70.246.54,167.235.145.223,207,131282,138,67287,69,63995,0.228533,82.310635,6539,6219
172.70.246.81,167.235.145.223,252,155931,168,78113,84,77818,0.676651,80.485188,7764,7734
172.70.246.86,167.235.145.223,6,427,2,132,4,295,1.363928,29.626583,35,79
172.70.246.93,167.235.145.223,165,2313676,74,6414,91,2307262,81.394014,0.0655,783389,281802992
172.70.246.95,167.235.145.223,231,4067233,112,9734,119,4057499,41.172915,31.830783,2446,1019767
172.70.246.102,167.235.145.223,90,56980,60,29187,30,27793,1.335978,78.403489,2978,2835
172.70.246.115,167.235.145.223,165,2899569,78,7358,87,2892211,72.906469,2.037023,28897,11358579
172.70.246.120,167.235.145.223,171,2422595,70,6150,101,2416445,9.047542,60.027866,819,322043
172.70.246.123,167.235.145.223,267,4949187,127,10369,140,4938818,10.188596,60.990905,1360,647810
172.70.246.134,167.235.145.223,139,2319200,65,6368,74,2312832,36.253534,32.658145,1559,566555
172.70.246.140,167.235.145.223,306,6839206,141,12194,165,6827012,65.206878,10.229674,9536,5338986
172.70.246.143,167.235.145.223,166,2664641,78,7363,88,2657278,12.521592,62.371945,944,340829
172.70.246.144,167.235.145.223,6,427,2,132,4,295,2.867988,29.993385,35,78
172.70.246.155,167.235.145.223,161,2120573,75,6471,86,2114102,39.534262,30.293937,1708,558290
172.70.246.157,167.235.145.223,241,4396413,114,9933,127,4386480,20.921356,42.466114,1871,826349
172.70.246.160,167.235.145.223,235,5096416,109,10283,126,5086133,48.804604,20.610719,3991,1974170
172.70.246.164,167.235.145.223,194,3990839,89,8963,105,3981876,54.894549,8.292553,8646,3841399
172.70.246.177,167.235.145.223,6,427,2,132,4,295,19.00603,29.972315,35,78
172.70.246.203,167.235.145.223,149,2428321,72,6830,77,2421491,42.016364,32.913718,1660,588566
172.70.246.221,167.235.145.223,244,4966013,104,9228,140,4956785,29.200434,31.785891,2322,1247543
172.70.246.228,167.235.145.223,223,4307751,103,9140,120,4298611,59.199232,1.804754,40515,19054612
172.70.246.244,167.235.145.223,242,4351197,115,9954,127,4341243,77.202071,1.824692,43641,19033318
172.70.246.251,167.235.145.223,6,427,2,132,4,295,21.428449,29.671865,35,79
172.70.247.7,167.235.145.223,253,4490624,123,10494,130,4480130,4.940233,62.037238,1353,577734
172.70.247.9,167.235.145.223,267,5190546,125,10581,142,5179965,46.993058,32.090688,2637,1291331
172.70.247.17,167.235.145.223,7,493,3,198,4,295,15.216288,29.97099,52,78
172.70.247.25,167.235.145.223,6,427,2,132,4,295,9.347462,29.736037,35,79
172.70.247.28,167.235.145.223,6,427,2,132,4,295,3.108551,29.973042,35,78
172.70.247.32,167.235.145.223,114,4223135,46,4749,68,4218386,12.980802,54.463195,697,619631
172.70.247.49,167.235.145.223,172,2130363,81,6876,91,2123487,15.386816,60.027527,916,283001
172.70.247.62,167.235.145.223,6,427,2,132,4,295,14.912793,29.961642,35,78
172.70.247.73,167.235.145.223,57,2051313,20,2167,37,2049146,1.009853,60.007546,288,273185
172.70.247.88,167.235.145.223,405,9878611,189,16562,216,9862049,27.392614,27.627302,4795,2855740
172.70.247.97,167.235.145.223,151,2169433,79,7424,72,2162009,60.829717,2.085292,28481,8294316
172.70.247.104,167.235.145.223,7,493,3,198,4,295,23.198986,29.989822,52,78
172.70.247.105,167.235.145.223,168,105991,112,54099,56,51892,0.698837,80.812558,5355,5137
172.70.247.126,167.235.145.223,162,2592034,82,7622,80,2584412,66.884662,2.060006,29599,10036522
172.70.247.128,167.235.145.223,7,493,3,198,4,295,27.336325,29.733502,53,79
172.70.247.135,167.235.145.223,192,118810,128,59438,64,59372,0.298783,81.20638,5855,5848
172.70.247.136,167.235.145.223,337,2176725,196,63934,141,2112791,0.443466,81.186686,6299,208190
172.70.247.143,167.235.145.223,165,2220284,74,6414,91,2213870,51.389465,30.093681,1705,588527
172.70.247.151,167.235.145.223,165,100137,110,49103,55,51034,2.764146,79.158254,4962,5157
172.70.247.165,167.235.145.223,453,285678,302,145788,151,139890,0.725334,80.946479,14408,13825
172.70.247.168,167.235.145.223,161,2387111,81,7561,80,2379550,0.456967,62.427976,968,304933
172.70.247.173,167.235.145.223,165,2881526,76,7231,89,2874295,30.600949,32.34762,1788,710851
172.70.247.182,167.235.145.223,60,2453603,21,2950,39,2450653,24.501595,32.430303,727,604534
172.70.247.188,167.235.145.223,335,7286671,176,15728,159,7270943,17.342369,55.675701,2259,1044756
172.70.247.193,167.235.145.223,158,2471253,75,7165,83,2464088,6.477996,62.405339,918,315881
172.70.247.196,167.235.145.223,126,80265,84,41352,42,38913,3.195319,78.097432,4235,3986
172.70.247.207,167.235.145.223,143,1766820,68,6018,75,1760802,33.374878,30.157281,1596,467098
172.70.247.209,167.235.145.223,84,53474,56,27538,28,25936,2.547364,78.096134,2820,2656
172.70.247.210,167.235.145.223,86,54975,57,28106,29,26869,0.932269,82.173461,2736,2615
172.70.250.13,167.235.145.223,163,2537966,83,7815,80,2530151,47.011158,33.217654,1882,609350
172.70.250.15,167.235.145.223,109,1167887,50,4738,59,1163149,22.972293,60.026129,631,155019
172.70.250.20,167.235.145.223,99,63259,66,32618,33,30641,1.361245,79.188441,3295,3095
172.70.250.21,167.235.145.223,99,62749,66,32176,33,30573,2.001457,79.019396,3257,3095
172.70.250.25,167.235.145.223,293,6347896,140,12466,153,6335430,35.134106,31.448285,3171,1611644
172.70.250.30,167.235.145.223,497,5297677,305,111643,192,5186034,0.857698,81.279729,10988,510438
172.70.250.44,167.235.145.223,217,2778142,109,8692,108,2769450,25.206775,30.082809,2311,736487
172.70.250.51,167.235.145.223,107,1221955,50,4738,57,1217217,58.790669,0.053423,709507,182276098
172.70.250.52,167.235.145.223,93,59584,62,30864,31,28720,1.472204,79.152572,3119,2902
172.70.250.59,167.235.145.223,63,2051853,27,2772,36,2049081,0.000955,60.00958,369,273167
172.70.250.61,167.235.145.223,132,1506850,65,5728,67,1501122,34.746284,30.212424,1516,397484
172.70.250.63,167.235.145.223,222,140498,148,71940,74,68558,0.465894,79.759785,7215,6876
172.70.250.65,167.235.145.223,164,2640480,77,7390,87,2633090,7.645357,63.064192,937,334020
172.70.250.69,167.235.145.223,119,1283023,59,5332,60,1277691,82.829012,0.051189,833304,199682119
172.70.250.76,167.235.145.223,364,8716462,169,15167,195,8701295,11.128142,59.443739,2041,1171029
172.70.250.86,167.235.145.223,42,26758,28,13790,14,12968,1.816853,78.019699,1414,1329
172.70.250.107,167.235.145.223,238,1232198,115,9289,123,1222909,42.759651,30.122005,2467,324788
172.70.250.121,167.235.145.223,301,6520141,143,12664,158,6507477,77.144101,2.066365,49029,25193911
172.70.250.126,167.235.145.223,165,99694,110,48733,55,50961,0.801064,80.280665,4856,5078
172.70.250.133,167.235.145.223,221,3980567,111,10421,110,3970146,4.808066,71.78456,1161,442451
172.70.250.137,167.235.145.223,114,73401,76,38204,38,35197,0.27954,80.245792,3808,3508
172.70.250.160,167.235.145.223,283,6094130,133,12004,150,6082126,41.12991,31.858548,3014,1527282
172.70.250.170,167.235.145.223,63,2054717,27,2629,36,2052088,19.191268,60.00937,350,273569
172.70.250.173,167.235.145.223,207,3975239,95,8615,112,3966624,31.268801,48.280237,1427,657266
172.70.250.185,167.235.145.223,148,2319855,70,6760,78,2313095,36.964564,37.25112,1451,496757
172.70.250.195,167.235.145.223,174,109587,116,55837,58,53750,1.673728,80.437337,5553,5345
172.70.250.196,167.235.145.223,105,1089328,53,5025,52,1084303,59.669292,0.051377,782451,168838663
172.70.250.197,167.235.145.223,6,427,2,132,4,295,25.294863,29.972616,35,78
172.70.250.202,167.235.145.223,6,427,2,132,4,295,19.28205,29.932647,35,78
172.70.250.204,167.235.145.223,129,1395302,62,5619,67,1389683,8.465855,45.277538,992,245540
172.70.250.207,167.235.145.223,117,1367349,53,5025,64,1362324,47.71157,30.506208,1317,357258
172.70.250.210,167.235.145.223,90,2654414,42,4261,48,2650153,12.942109,66.838305,510,317201
172.70.250.217,167.235.145.223,39,24901,26,12857,13,12044,2.270676,75.45383,1363,1276
172.70.250.228,167.235.145.223,81,51542,54,26530,27,25012,2.818391,78.042625,2719,2563
172.70.250.239,167.235.145.223,160,2120484,71,6184,89,2114300,37.226509,30.446631,1624,555542
172.70.250.240,167.235.145.223,6,427,2,132,4,295,13.052545,29.988044,35,78
172.70.250.243,167.235.145.223,115,1206664,58,5266,57,1201398,28.859608,30.355623,1387,316619
172.70.251.2,167.235.145.223,299,6872642,132,11938,167,6860704,23.129079,31.25187,3055,1756235
172.70.251.4,167.235.145.223,167,2881583,79,7354,88,2874229,30.955659,37.061383,1587,620425
172.70.251.6,167.235.145.223,167,2130001,78,6646,89,2123355,13.19735,60.027241,885,282985
172.70.251.8,167.235.145.223,119,1301189,59,5421,60,1295768,65.621606,0.048555,893172,213492822
172.70.251.21,167.235.145.223,6,427,2,132,4,295,23.233145,29.834864,35,79
172.70.251.25,167.235.145.223,109,1197994,54,5002,55,1192992,64.66724,0.050983,784889,187198399
172.70.251.28,167.235.145.223,6,427,2,132,4,295,20.215166,29.630352,35,79
172.70.251.29,167.235.145.223,179,111505,119,55839,60,55666,1.131488,81.181004,5502,5485
172.70.251.33,167.235.145.223,314,6729018,148,12994,166,6716024,5.124065,61.156489,1699,878536
172.70.251.35,167.235.145.223,113,1231493,55,5157,58,1226336,78.716446,0.051072,807800,192095238
172.70.251.47,167.235.145.223,322,7779407,139,12412,183,7766995,47.139743,31.968155,3106,1943683
172.70.251.50,167.235.145.223,117,1303976,55,5068,62,1298908,76.937124,0.056126,722374,185141716
172.70.251.56,167.235.145.223,6,427,2,132,4,295,11.721132,29.984392,35,78
172.70.251.57,167.235.145.223,190,2327386,92,7570,98,2319816,1.232206,60.027359,1008,309167
172.70.251.62,167.235.145.223,154,2470914,73,6958,81,2463956,6.941315,66.945438,831,294443
172.70.251.65,167.235.145.223,105,65160,70,32734,35,32426,0.998434,82.060008,3191,3161
172.70.251.66,167.235.145.223,163,2353200,93,34589,70,2318611,0.895206,78.463389,3526,236401
172.70.251.69,167.235.145.223,6,427,2,132,4,295,2.082239,29.613237,35,79
172.70.251.76,167.235.145.223,134,80938,87,38074,47,42864,1.317365,78.043792,3902,4393
172.70.251.79,167.235.145.223,188,2384492,95,7768,93,2376724,43.184456,30.305441,2050,627405
172.70.251.82,167.235.145.223,327,3879863,165,13915,162,3865948,7.185606,65.121925,1709,474918
172.70.251.85,167.235.145.223,182,2314572,89,7177,93,2307395,81.195469,0.062722,915404,294301202
172.70.251.91,167.235.145.223,6,427,2,132,4,295,10.927262,29.871445,35,79
172.70.251.96,167.235.145.223,304,7442441,129,11740,175,7430701,29.127817,31.501668,2981,1887062
172.70.251.104,167.235.145.223,152,2464735,73,6958,79,2457777,24.943647,37.231597,1495,528105
172.70.251.125,167.235.145.223,104,995750,51,4804,53,990946,40.634747,30.51223,1259,259816
172.70.251.128,167.235.145.223,6,427,2,132,4,295,14.265709,29.699025,35,79
172.70.251.132,167.235.145.223,192,121700,128,62335,64,59365,0.317296,81.006617,6156,5862
172.70.251.137,167.235.145.223,322,7073894,150,13138,172,7060756,17.140119,61.199321,1717,922984
172.70.251.155,167.235.145.223,6,427,2,132,4,295,12.731463,29.7063,35,79
172.70.251.156,167.235.145.223,311,7712457,131,11872,180,7700585,71.138255,2.023757,46930,30440749
172.70.251.159,167.235.145.223,291,178576,194,88701,97,89875,0.165136,81.408956,8716,8831
172.70.251.167,167.235.145.223,6,427,2,132,4,295,24.170049,29.996554,35,78
172.70.251.169,167.235.145.223,60,38480,40,19950,20,18530,2.669485,76.955346,2073,1926
172.70.251.170,167.235.145.223,60,38968,40,20442,20,18526,1.620726,77.486743,2110,1912
172.70.251.180,167.235.145.223,6,427,2,132,4,295,9.560252,29.584298,35,79
172.70.251.182,167.235.145.223,304,7243368,132,11742,172,7231626,52.817126,2.274975,41291,25430173
172.70.251.184,167.235.145.223,369,9678057,160,14633,209,9663424,65.131948,2.220594,52717,34813834
172.70.251.199,167.235.145.223,156,2081029,73,6316,83,2074713,55.292107,0.065638,769797,252867302
172.70.251.201,167.235.145.223,47,1330396,21,2164,26,1328232,2.108404,60.007502,288,177075
172.70.251.215,167.235.145.223,6,427,2,132,4,295,16.864835,29.804829,35,79
172.70.251.227,167.235.145.223,6,427,2,132,4,295,13.482781,29.69874,35,79
172.71.94.3,167.235.145.223,6,427,2,132,4,295,20.146196,29.820934,35,79
172.71.94.11,167.235.145.223,164,1340153,84,6880,80,1333273,11.048494,60.049551,916,177623
172.71.94.13,167.235.145.223,6,427,2,132,4,295,17.292794,29.771086,35,79
172.71.94.15,167.235.145.223,466,8988299,249,20355,217,8967944,22.638982,45.732102,3560,1568778
172.71.94.18,167.235.145.223,192,1170224,118,9124,74,1161100,35.068202,30.142786,2421,308159
172.71.94.20,167.235.145.223,7,493,3,198,4,295,14.026584,29.933502,52,78
172.71.94.22,167.235.145.223,39,23865,26,11826,13,12039,5.274714,60.026897,1576,1604
172.71.94.34,167.235.145.223,223,2386827,113,8982,110,2377845,43.911989,30.24149,2376,629028
172.71.94.39,167.235.145.223,24,15330,16,7916,8,7414,11.015412,65.771678,962,901
172.71.94.43,167.235.145.223,6,427,2,132,4,295,5.22922,29.880498,35,78
172.71.94.47,167.235.145.223,220,2305269,113,8982,107,2296287,73.918466,0.115154,623999,159528075
172.71.94.57,167.235.145.223,51,31135,34,15386,17,15749,1.537333,78.536863,1567,1604
172.71.94.59,167.235.145.223,248,3435604,126,10719,122,3424885,49.91459,4.848587,17685,5650941
172.71.94.61,167.235.145.223,39,1435227,15,1675,24,1433552,9.148041,50.176027,267,228563
172.71.94.70,167.235.145.223,318,5193722,157,12503,161,5181219,47.191731,32.466868,3080,1276678
172.71.94.71,167.235.145.223,257,2605984,139,10657,118,2595327,47.228261,30.318449,2812,684817
172.71.94.72,167.235.145.223,135,83093,90,41406,45,41687,1.385937,78.857458,4200,4229
172.71.94.75,167.235.145.223,7,493,3,198,4,295,29.869098,29.635748,53,79
172.71.94.78,167.235.145.223,160,1312922,86,7206,74,1305716,64.305346,0.105855,544594,98679590
172.71.94.81,167.235.145.223,140,4104444,71,6512,69,4097932,0.072915,62.984955,827,520496
172.71.94.88,167.235.145.223,241,6759480,113,30687,128,6728793,2.216041,77.573109,3164,693930
172.71.94.94,167.235.145.223,265,3563267,133,11181,132,3552086,1.898058,62.747912,1425,452870
172.71.94.99,167.235.145.223,6,427,2,132,4,295,8.268286,29.657597,35,79
172.71.94.106,167.235.145.223,300,4722911,149,12381,151,4710530,16.628727,62.233661,1591,605528
172.71.94.107,167.235.145.223,211,2367618,97,7554,114,2360064,16.622916,60.04952,1006,314415
172.71.94.109,167.235.145.223,90,56020,60,28232,30,27788,0.658138,80.239893,2814,2770
172.71.94.117,167.235.145.223,141,1200198,68,6018,73,1194180,58.290139,0.121512,396207,78621370
172.71.94.124,167.235.145.223,172,1244251,95,7606,77,1236645,5.041075,60.050035,1013,164748
172.71.94.128,167.235.145.223,7,493,3,198,4,295,21.143506,29.939654,52,78
172.71.94.130,167.235.145.223,233,2426309,120,9072,113,2417237,2.259351,51.16485,1418,377952
172.71.94.131,167.235.145.223,285,4836293,134,11316,151,4824977,53.232035,2.226869,40652,17333671
172.71.94.133,167.235.145.223,343,6097836,179,14787,164,6083049,41.083401,32.123714,3682,1514905
172.71.94.134,167.235.145.223,383,8277540,188,16254,195,8261286,31.902739,48.3173,2691,1367839
172.71.94.140,167.235.145.223,163,1303902,86,7012,77,1296890,68.277918,0.105034,534074,98778681
172.71.94.151,167.235.145.223,387,9232834,189,16132,198,9216702,23.049809,51.221439,2519,1439506
172.71.94.154,167.235.145.223,48,29914,32,15093,16,14821,0.438862,78.020268,1547,1519
172.71.94.155,167.235.145.223,51,32676,34,16855,17,15821,0.364346,80.358822,1677,1575
172.71.94.158,167.235.145.223,194,2083563,91,7530,103,2076033,55.928168,0.113217,532075,146694083
172.71.94.160,167.235.145.223,6,427,2,132,4,295,26.181115,29.797052,35,79
172.71.94.167,167.235.145.223,165,1307236,88,7338,77,1299898,70.422344,0.157142,373572,66176986
172.71.94.171,167.235.145.223,37,1356936,14,1803,23,1355133,27.074641,55.488099,259,195376
172.71.94.172,167.235.145.223,69,43070,46,21689,23,21381,1.092379,79.375556,2185,2154
172.71.94.179,167.235.145.223,6,427,2,132,4,295,15.093229,29.945912,35,78
172.71.94.181,167.235.145.223,7,493,3,198,4,295,3.270559,29.73059,53,79
172.71.94.185,167.235.145.223,214,2425426,100,8124,114,2417302,7.915867,60.046097,1082,322059
172.71.94.186,167.235.145.223,380,7420162,184,15117,196,7405045,11.214889,61.17922,1976,968308
172.71.94.188,167.235.145.223,57,34940,38,17334,19,17606,0.493438,80.596724,1720,1747
172.71.94.189,167.235.145.223,57,35164,38,17492,19,17672,1.571109,81.185532,1723,1741
172.71.94.191,167.235.145.223,214,2727883,111,9370,103,2718513,47.120254,30.730341,2439,707707
172.71.94.194,167.235.145.223,178,1509978,96,7866,82,1502112,39.306796,30.116109,2089,399018
172.71.94.198,167.235.145.223,6,427,2,132,4,295,29.355255,29.721134,35,79
172.71.94.202,167.235.145.223,48,29134,32,14311,16,14823,5.112876,75.046764,1525,1580
172.71.94.203,167.235.145.223,48,28759,32,13936,16,14823,4.916506,74.559827,1495,1590
172.71.94.204,167.235.145.223,63,39094,42,19638,21,19456,4.52984,72.982823,2152,2132
172.71.94.205,167.235.145.223,66,41403,44,21024,22,20379,1.392495,78.101245,2153,2087
172.71.94.208,167.235.145.223,175,2430003,84,7588,91,2422415,41.068949,30.988001,1958,625381
172.71.94.212,167.235.145.223,213,2386168,102,8256,111,2377912,68.065795,0.157288,419917,120945628
172.71.94.216,167.235.145.223,6,427,2,132,4,295,11.456303,29.692737,35,79
172.71.94.218,167.235.145.223,353,2142302,183,13602,170,2128700,13.903572,60.048473,1812,283597
172.71.94.222,167.235.145.223,108,1125999,67,26254,41,1099745,0.353069,82.572913,2543,106547
172.71.94.223,167.235.145.223,105,1123731,65,24869,40,1098862,1.795546,78.195578,2544,112421
172.71.94.225,167.235.145.223,410,8405993,207,17583,203,8388410,19.908392,47.433537,2965,1414764
172.71.94.230,167.235.145.223,399,7312837,209,16767,190,7296070,65.242074,2.741387,48929,21291616
172.71.94.239,167.235.145.223,21,11857,14,5371,7,6486,4.274603,55.508763,774,934
172.71.94.246,167.235.145.223,252,2780478,128,9972,124,2770506,25.9296,30.155276,2645,734997
172.71.94.249,167.235.145.223,453,9619423,227,18903,226,9600520,28.676907,54.367589,2781,1412682
172.71.94.254,167.235.145.223,165,1267910,88,7144,77,1260766,17.044319,60.058089,951,167939
172.71.95.7,167.235.145.223,143,1275646,68,6018,75,1269628,47.208994,30.404682,1583,334061
172.71.95.27,167.235.145.223,14,5971,8,2994,6,2977,5.035306,68.39628,350,348
172.71.98.7,167.235.145.223,202,3522873,86,7998,116,3514875,31.161011,32.865099,1946,855588
172.71.98.19,167.235.145.223,167,2321292,77,7405,90,2313887,35.290624,32.558904,1819,568541
172.71.98.26,167.235.145.223,198,123247,132,62108,66,61139,1.29095,80.012432,6209,6112
172.71.98.27,167.235.145.223,244,1436354,158,63645,86,1372709,0.597629,80.558601,6320,136319
172.71.98.28,167.235.145.223,168,105541,112,53670,56,51871,1.444106,80.169237,5355,5176
172.71.98.29,167.235.145.223,168,105273,112,53255,56,52018,0.744953,80.153892,5315,5191
172.71.98.31,167.235.145.223,491,11266316,240,20498,251,11245818,67.308668,12.131155,13517,7416156
172.71.98.32,167.235.145.223,280,4594785,133,11119,147,4583666,73.309305,2.730702,32574,13428535
172.71.98.40,167.235.145.223,140,1224226,67,5954,73,1218272,49.704271,30.106902,1582,323718
172.71.98.44,167.235.145.223,245,4152496,108,9469,137,4143027,55.301117,2.722165,27827,12175682
172.71.98.46,167.235.145.223,196,2781234,94,8527,102,2772707,53.267176,2.543172,26823,8722043
172.71.98.62,167.235.145.223,222,139493,148,70935,74,68558,0.691277,79.849723,7106,6868
172.71.98.63,167.235.145.223,222,138927,148,70379,74,68548,0.617016,79.859237,7050,6866
172.71.98.71,167.235.145.223,6,427,3,198,3,229,1.181617,29.996498,52,61
172.71.98.73,167.235.145.223,39,1284712,14,1724,25,1282988,1.785509,60.012474,229,171029
172.71.98.89,167.235.145.223,150,1312263,73,6350,77,1305913,61.710682,0.103446,491077,100992827
172.71.98.93,167.235.145.223,94,2654861,48,4840,46,2650021,11.309606,62.500549,619,339199
172.71.98.100,167.235.145.223,138,1284371,64,5756,74,1278615,73.691141,0.107069,430077,95535775
172.71.98.110,167.235.145.223,118,996767,51,4898,67,991869,31.684761,30.224083,1296,262537
172.71.98.113,167.235.145.223,6,427,2,132,4,295,27.171165,29.707772,35,79
172.71.98.119,167.235.145.223,368,7780906,171,14257,197,7766649,47.09065,31.991571,3565,1942173
172.71.98.128,167.235.145.223,363,226272,242,114037,121,112235,0.517055,81.677187,11169,10993
172.71.98.130,167.235.145.223,150,91620,100,45293,50,46327,0.956944,79.247194,4572,4676
172.71.98.131,167.235.145.223,150,91747,100,45421,50,46326,0.960043,80.361239,4521,4611
172.71.98.136,167.235.145.223,6,427,2,132,4,295,22.009607,29.973491,35,78
172.71.98.141,167.235.145.223,299,6095201,130,11822,169,6083379,41.098603,32.360765,2922,1503890
172.71.98.145,167.235.145.223,182,2593466,86,7999,96,2585467,65.366263,2.457558,26038,8416377
172.71.98.147,167.235.145.223,6,427,2,132,4,295,19.86596,29.966496,35,78
172.71.98.153,167.235.145.223,382,7420517,187,15537,195,7404980,11.035466,64.308513,1932,921181
172.71.98.160,167.235.145.223,40,1188349,16,1856,24,1186493,4.044799,60.01374,247,158162
172.71.98.174,167.235.145.223,310,6348973,140,12420,170,6336553,34.06957,33.321824,2981,1521297
172.71.98.205,167.235.145.223,265,5414890,113,10680,152,5404210,19.289304,48.444966,1763,892428
172.71.98.209,167.235.145.223,6,427,2,132,4,295,6.289222,29.833523,35,79
172.71.98.221,167.235.145.223,6,427,2,132,4,295,7.765188,29.943703,35,78
172.71.98.224,167.235.145.223,303,6728004,125,11188,178,6716816,5.030371,63.146396,1417,850951
172.71.98.229,167.235.145.223,234,4612687,109,11133,125,4601554,59.24871,20.57741,4328,1788973
172.71.98.231,167.235.145.223,6,427,2,132,4,295,8.170075,29.93925,35,78
172.71.98.246,167.235.145.223,295,6872341,114,10714,181,6861627,22.695167,35.03273,2446,1566906
172.71.98.248,167.235.145.223,180,113833,120,58245,60,55588,0.907134,80.253293,5806,5541
172.71.98.249,167.235.145.223,177,111480,118,56826,59,54654,0.977809,79.629423,5709,5490
172.71.98.250,167.235.145.223,141,89217,94,45601,47,43616,0.399886,81.201232,4492,4297
172.71.98.251,167.235.145.223,141,89098,94,45557,47,43541,1.198071,81.131505,4492,4293
172.71.99.5,167.235.145.223,382,8008070,176,14879,206,7993191,71.474922,1.90288,62553,33604603
172.71.99.8,167.235.145.223,138,1254233,64,5756,74,1248477,82.848411,0.105646,435870,94540408
172.71.99.10,167.235.145.223,285,4757838,135,11251,150,4746587,43.30436,32.711053,2751,1160852
172.71.99.12,167.235.145.223,145,1170357,70,6152,75,1164205,13.657807,60.048231,819,155102
172.71.99.13,167.235.145.223,204,122134,136,59145,68,62989,0.663958,80.996302,5841,6221
172.71.99.14,167.235.145.223,237,1477770,150,61630,87,1416140,1.094705,80.140021,6152,141366
172.71.99.19,167.235.145.223,6,427,2,132,4,295,4.006948,29.982309,35,78
172.71.99.26,167.235.145.223,331,7245362,145,12812,186,7232550,53.097078,1.986467,51597,29127289
172.71.99.28,167.235.145.223,6,427,2,132,4,295,0.629005,29.601565,35,79
172.71.99.34,167.235.145.223,6,427,2,132,4,295,10.320985,29.937606,35,78
172.71.99.36,167.235.145.223,342,6940167,176,15629,166,6924538,17.254102,64.789447,1929,855020
172.71.99.43,167.235.145.223,330,205424,220,103519,110,101905,0.14174,81.801913,10123,9966
172.71.99.44,167.235.145.223,165,102270,110,51316,55,50954,0.613312,80.553023,5096,5060
172.71.99.45,167.235.145.223,198,124737,132,63590,66,61147,0.235869,79.872524,6369,6124
172.71.99.46,167.235.145.223,198,123660,132,62509,66,61151,0.761881,80.689445,6197,6062
172.71.99.47,167.235.145.223,267,4617799,123,10266,144,4607533,81.415974,0.674004,121850,54688494
172.71.99.49,167.235.145.223,139,1200068,66,5888,73,1194180,55.698322,0.104195,452075,91688084
172.71.99.58,167.235.145.223,128,4103325,60,5460,68,4097865,1.355512,60.698428,719,540095
172.71.99.75,167.235.145.223,198,125106,132,63825,66,61281,1.101211,79.685324,6407,6152
172.71.99.76,167.235.145.223,99,62588,66,31726,33,30862,0.938371,79.346456,3198,3111
172.71.99.77,167.235.145.223,297,180710,198,88992,99,91718,1.346338,81.385766,8747,9015
172.71.99.82,167.235.145.223,6,427,2,132,4,295,16.026235,29.963688,35,78
172.71.99.83,167.235.145.223,142,1359982,62,5624,80,1354358,7.667623,60.046308,749,180441
172.71.99.92,167.235.145.223,44,1330220,18,1988,26,1328232,3.259649,60.012346,265,177061
172.71.99.103,167.235.145.223,153,1246201,74,6416,79,1239785,19.697081,60.046003,854,165178
172.71.99.108,167.235.145.223,371,9525989,148,14635,223,9511354,17.085801,38.860079,3012,1958071
172.71.99.109,167.235.145.223,148,2166412,84,31578,64,2134834,0.527662,79.923836,3160,213686
172.71.99.110,167.235.145.223,147,2165856,84,32254,63,2133602,2.275572,78.010745,3307,218800
172.71.99.113,167.235.145.223,465,6472567,221,18184,244,6454383,59.09375,2.292983,63442,22518729
172.71.99.122,167.235.145.223,6,427,2,132,4,295,1.995942,29.673859,35,79
172.71.99.124,167.235.145.223,136,1275186,61,5558,75,1269628,37.766264,30.340966,1465,334762
172.71.99.134,167.235.145.223,335,7444451,143,12628,192,7431823,28.725486,35.081869,2879,1694738
172.71.99.137,167.235.145.223,7,493,3,198,4,295,25.836126,29.943175,52,78
172.71.99.140,167.235.145.223,318,5543469,148,12090,170,5531379,25.223508,32.81999,2946,1348295
172.71.99.149,167.235.145.223,305,4982553,144,12085,161,4970468,7.30374,62.748092,1540,633704
172.71.99.163,167.235.145.223,6,427,2,132,4,295,9.481822,29.965175,35,78
172.71.99.171,167.235.145.223,174,2430216,80,7603,94,2422613,41.229842,32.60571,1865,594402
172.71.99.174,167.235.145.223,273,4642541,123,10459,150,4632082,27.99711,36.03348,2322,1028395
172.71.99.176,167.235.145.223,196,2883680,93,8461,103,2875219,29.367275,32.508785,2082,707554
172.71.99.182,167.235.145.223,6,427,2,132,4,295,14.056605,29.671389,35,79
172.71.99.186,167.235.145.223,372,228201,248,113193,124,115008,0.73056,80.451812,11255,11436
172.71.99.194,167.235.145.223,275,5187955,137,13037,138,5174918,5.214688,74.809633,1394,553395
172.71.99.197,167.235.145.223,369,7311146,177,14945,192,7296201,65.396681,1.68541,70938,34632290
172.71.99.198,167.235.145.223,280,5480742,127,10936,153,5469806,1.284572,62.746815,1394,697381
172.71.99.208,167.235.145.223,177,2900474,72,7075,105,2893399,71.295437,2.607565,21706,8876937
172.71.99.214,167.235.145.223,266,161077,174,78255,92,82822,0.791793,80.829967,7745,8197
172.71.99.215,167.235.145.223,447,276225,298,138201,149,138024,0.365535,80.759269,13690,13672
172.71.99.219,167.235.145.223,134,4311851,61,5776,73,4306075,13.283432,62.75776,736,548913
172.71.102.12,167.235.145.223,6,427,2,132,4,295,28.142073,29.817872,35,79
172.71.102.21,167.235.145.223,6,427,2,132,4,295,13.696348,29.954817,35,78
172.71.102.28,167.235.145.223,332,6458959,162,13945,170,6445014,58.184824,2.682013,41595,19224407
172.71.102.31,167.235.145.223,155,1508462,74,6416,81,1502046,28.19111,30.194137,1699,397970
172.71.102.41,167.235.145.223,267,4641808,121,10022,146,4631786,60.597024,0.945227,84821,39201470
172.71.102.49,167.235.145.223,171,2321493,80,7539,91,2313954,36.693376,30.934615,1949,598411
172.71.102.54,167.235.145.223,6,427,2,132,4,295,11.235058,29.988539,35,78
172.71.102.61,167.235.145.223,172,2430020,79,7473,93,2422547,42.696346,31.353531,1906,618124
172.71.102.64,167.235.145.223,6,427,2,132,4,295,4.010198,29.959691,35,78
172.71.102.75,167.235.145.223,900,567450,600,289212,300,278238,0.808312,80.855658,28615,27529
172.71.102.106,167.235.145.223,849,7276786,520,219987,329,7056799,0.267463,80.68172,21812,699717
172.71.102.110,167.235.145.223,618,2921549,396,168707,222,2752842,0.710482,81.046215,16652,271730
172.71.102.111,167.235.145.223,431,5344193,260,91189,171,5253004,0.210252,81.483433,8952,515737
172.71.102.112,167.235.145.223,361,3882077,169,14150,192,3867927,82.16493,0.192748,587295,160538194
172.71.102.118,167.235.145.223,6,427,2,132,4,295,15.987261,29.967672,35,78
172.71.102.119,167.235.145.223,196,2781171,94,8463,102,2772708,54.722905,1.056597,64077,20993495
172.71.102.120,167.235.145.223,229,3524369,111,9362,118,3515007,30.196156,31.379587,2386,896125
172.71.102.124,167.235.145.223,145,1369202,65,5822,80,1363380,46.213934,30.29903,1537,359979
172.71.102.129,167.235.145.223,197,7430025,82,7770,115,7422255,27.904679,32.244831,1927,1841474
172.71.102.135,167.235.145.223,151,1327430,71,6218,80,1321212,4.159231,60.048964,828,176017
172.71.102.138,167.235.145.223,600,374779,400,189352,200,185427,0.00369,82.08604,18454,18071
172.71.102.144,167.235.145.223,251,4152587,118,9824,133,4142763,54.521902,1.041664,75448,31816501
172.71.102.150,167.235.145.223,638,7029875,392,138392,246,6891483,0.395554,80.941327,13678,681133
172.71.102.151,167.235.145.223,319,4184708,185,70473,134,4114235,0.761775,82.049908,6871,401144
172.71.102.166,167.235.145.223,675,423941,450,215418,225,208523,0.596196,81.914277,21038,20364
172.71.102.167,167.235.145.223,225,140042,150,70486,75,69556,0.462239,80.697252,6987,6895
172.71.102.169,167.235.145.223,303,5542193,136,11012,167,5531181,25.319543,30.451699,2892,1453102
172.71.102.170,167.235.145.223,144,1275714,68,6020,76,1269694,40.210442,30.460729,1581,333463
172.71.102.173,167.235.145.223,136,1169763,63,5690,73,1164073,16.171262,60.051605,758,155076
172.71.102.177,167.235.145.223,346,6730855,164,13776,182,6717079,4.768922,60.812093,1812,883650
172.71.102.178,167.235.145.223,513,324435,342,165873,171,158562,0.369425,80.89899,16402,15679
172.71.102.183,167.235.145.223,533,10608330,228,20416,305,10587914,10.174276,72.090587,2265,1174956
172.71.102.193,167.235.145.223,185,2472970,86,7826,99,2465144,6.205201,61.494665,1018,320696
172.71.102.205,167.235.145.223,257,4617358,115,9957,142,4607401,81.040457,0.963587,82666,38252081
172.71.102.218,167.235.145.223,6,427,2,132,4,295,16.587401,29.598666,35,79
172.71.102.225,167.235.145.223,276,4642784,125,10636,151,4632148,1.521848,62.444351,1362,593443
172.71.102.229,167.235.145.223,145,1311934,71,6218,74,1305716,64.235834,0.107912,460968,96798576
172.71.102.230,167.235.145.223,605,2438057,372,140613,233,2297444,0.284844,82.442716,13644,222937
172.71.102.231,167.235.145.223,937,4855206,597,270121,340,4585085,0.353617,82.640069,26149,443860
172.71.102.232,167.235.145.223,205,7403762,87,8349,118,7395413,10.762706,61.169316,1091,967205
172.71.102.237,167.235.145.223,42,1188510,18,2018,24,1186492,0.664745,60.013263,269,158163
172.71.102.239,167.235.145.223,182,2466696,86,7797,96,2458899,24.255297,31.620587,1972,622100
172.71.102.248,167.235.145.223,513,311414,342,153006,171,158408,0.288388,82.325466,14868,15393
172.71.103.3,167.235.145.223,480,298390,320,149941,160,148449,0.388741,81.511532,14716,14569
172.71.103.4,167.235.145.223,240,148948,160,74836,80,74112,1.065772,81.678982,7329,7258
172.71.103.8,167.235.145.223,168,2453945,78,7473,90,2446472,76.657534,0.964815,61964,20285522
172.71.103.9,167.235.145.223,125,1199144,56,5228,69,1193916,58.237065,0.108116,386843,88343334
172.71.103.11,167.235.145.223,269,4431032,126,10352,143,4420680,48.440611,31.185169,2655,1134046
172.71.103.21,167.235.145.223,6,427,2,132,4,295,28.50897,29.694911,35,79
172.71.103.32,167.235.145.223,7,493,3,198,4,295,5.312873,29.89029,52,78
172.71.103.37,167.235.145.223,225,139473,150,69983,75,69490,0.15062,81.979629,6829,6781
172.71.103.38,167.235.145.223,447,276620,298,138571,149,138049,0.26075,81.879616,13538,13487
172.71.103.55,167.235.145.223,285,176520,189,90100,96,86420,0.739344,81.588903,8834,8473
172.71.103.56,167.235.145.223,144,90493,96,46025,48,44468,1.38451,81.380455,4524,4371
172.71.103.58,167.235.145.223,127,997362,61,5558,66,991804,34.192122,30.177815,1473,262922
172.71.103.60,167.235.145.223,286,4757598,138,11144,148,4746454,66.672046,0.8747,101922,43411034
172.71.103.63,167.235.145.223,266,1394949,171,72982,95,1321967,1.134225,80.307915,7270,131689
172.71.103.64,167.235.145.223,496,1539412,324,145809,172,1393603,0.855189,81.804695,14259,136285
172.71.103.67,167.235.145.223,482,7323725,217,18220,265,7305505,65.208424,1.661258,87740,35180592
172.71.103.70,167.235.145.223,156,4822589,76,6751,80,4815838,7.53856,62.420489,865,617212
172.71.103.71,167.235.145.223,272,4593952,129,10550,143,4583402,72.758569,0.767332,109991,47785334
172.71.103.74,167.235.145.223,257,4249794,117,10108,140,4239686,13.539055,62.429647,1295,543291
172.71.103.87,167.235.145.223,134,1223831,62,5624,72,1218207,52.235068,30.113263,1494,323633
172.71.103.89,167.235.145.223,6,427,2,132,4,295,1.925911,29.950024,35,78
172.71.103.93,167.235.145.223,490,7653401,235,19551,255,7633850,17.006933,60.749032,2574,1005296
172.71.103.97,167.235.145.223,567,352347,378,177178,189,175169,0.354318,80.988962,17501,17302
172.71.103.98,167.235.145.223,285,176870,190,88776,95,88094,0.262301,80.660336,8804,8737
172.71.103.102,167.235.145.223,7,493,3,198,4,295,9.982755,29.968286,52,78
172.71.103.103,167.235.145.223,186,2665811,83,7543,103,2658268,12.234532,61.377168,983,346482
172.71.103.106,167.235.145.223,6,427,2,132,4,295,24.703009,29.997331,35,78
172.71.103.113,167.235.145.223,6,427,2,132,4,295,19.584606,29.996361,35,78
172.71.103.117,167.235.145.223,177,2593016,81,7549,96,2585467,66.700392,0.901079,67021,22954409
172.71.103.126,167.235.145.223,879,544681,586,274473,293,270208,0.055275,82.761698,26531,26119
172.71.103.136,167.235.145.223,145,1305918,70,6152,75,1299766,70.261084,0.107092,459567,97095282
172.71.103.138,167.235.145.223,7,493,3,198,4,295,5.362022,29.9188,52,78
172.71.103.142,167.235.145.223,6,427,2,132,4,295,23.573643,29.996253,35,78
172.71.103.159,167.235.145.223,760,2591985,496,223677,264,2368308,0.049743,82.947779,21572,228414
172.71.103.160,167.235.145.223,345,216506,230,109905,115,106601,0.205061,82.201107,10696,10374
172.71.103.168,167.235.145.223,180,2725854,80,7539,100,2718315,48.693771,31.248789,1930,695915
172.71.103.176,167.235.145.223,255,4231233,119,9890,136,4221343,36.282656,31.319288,2526,1078273
172.71.103.182,167.235.145.223,310,6349054,139,12436,171,6336618,34.682423,31.696463,3138,1599324
172.71.103.192,167.235.145.223,201,2883946,98,8727,103,2875219,30.682521,31.05873,2247,740588
172.71.103.202,167.235.145.223,138,1284371,63,5690,75,1278681,76.249195,0.110322,412610,92723554
172.71.103.205,167.235.145.223,255,4123094,118,10174,137,4112920,19.535542,62.440317,1303,526956
172.71.103.210,167.235.145.223,348,7210311,161,13895,187,7196416,52.910804,1.693318,65646,33999123
172.71.103.212,167.235.145.223,133,1142392,62,5612,71,1136780,82.598601,0.105209,426731,86439753
172.71.103.220,167.235.145.223,190,2901268,86,7935,104,2893333,72.680016,1.259423,50404,18378784
172.71.103.233,167.235.145.223,149,1245937,72,6284,77,1239653,22.171142,60.054169,837,165137
172.71.114.3,167.235.145.223,248,3677978,119,10910,129,3667068,78.263529,3.928108,22219,7468364
172.71.114.5,167.235.145.223,234,2318210,107,8540,127,2309670,25.302999,57.252218,1193,322736
172.71.114.7,167.235.145.223,296,4589488,128,10451,168,4579037,23.218833,32.774478,2551,1117707
172.71.114.20,167.235.145.223,378,232028,252,115222,126,116806,0.506364,82.302132,11199,11353
172.71.114.21,167.235.145.223,378,233676,252,116941,126,116735,0.046684,82.656453,11318,11298
172.71.114.28,167.235.145.223,236,3252160,115,10529,121,3241631,60.255878,3.950612,21321,6564311
172.71.114.32,167.235.145.223,161,1276793,64,5713,97,1271080,39.3612,30.407829,1503,334408
172.71.114.41,167.235.145.223,333,4971857,151,12250,182,4959607,28.448586,33.603963,2916,1180719
172.71.114.45,167.235.145.223,136,5294121,48,6434,88,5287687,2.257907,74.082947,694,571001
172.71.114.48,167.235.145.223,6,427,2,132,4,295,20.763707,29.690405,35,79
172.71.114.53,167.235.145.223,218,2324476,104,9005,114,2315471,36.956394,30.262904,2380,612094
172.71.114.54,167.235.145.223,265,3575252,124,10483,141,3564769,0.999434,72.238799,1160,394776
172.71.114.55,167.235.145.223,183,2412577,75,7117,108,2405460,1.171661,80.255864,709,239779
172.71.114.57,167.235.145.223,6,427,2,132,4,295,1.279591,29.870489,35,79
172.71.114.58,167.235.145.223,235,2306213,111,8804,124,2297409,73.185546,0.227226,309964,80885426
172.71.114.60,167.235.145.223,319,5595864,139,12015,180,5583849,77.233794,4.099021,23449,10897917
172.71.114.62,167.235.145.223,345,5345998,146,11639,199,5334359,71.23287,2.710477,34352,15744413
172.71.114.69,167.235.145.223,421,6478433,182,16196,239,6462237,42.664647,19.319513,6706,2675941
172.71.114.72,167.235.145.223,185,1371799,82,6901,103,1364898,46.035421,30.474907,1811,358300
172.71.114.75,167.235.145.223,276,3697897,128,11527,148,3686370,24.435187,33.917323,2718,869495
172.71.114.83,167.235.145.223,256,4166526,116,10564,140,4155962,54.015027,5.965844,14165,5573007
172.71.114.84,167.235.145.223,6,427,2,132,4,295,24.895415,29.994477,35,78
172.71.114.89,167.235.145.223,6,427,2,132,4,295,13.55612,29.625856,35,79
172.71.114.91,167.235.145.223,271,3887249,128,11356,143,3875893,65.852176,4.358411,20844,7114323
172.71.114.94,167.235.145.223,281,4835770,125,10463,156,4825307,52.42959,3.513211,23825,10987798
172.71.114.96,167.235.145.223,178,1000684,82,6901,96,993783,32.423022,30.428927,1814,261273
172.71.114.104,167.235.145.223,6,427,2,132,4,295,5.628531,29.807391,35,79
172.71.114.107,167.235.145.223,421,7964670,200,16868,221,7947802,13.080238,44.000004,3066,1445054
172.71.114.111,167.235.145.223,6,427,2,132,4,295,8.379002,29.953719,35,78
172.71.114.116,167.235.145.223,410,6650758,203,16999,207,6633759,11.195717,69.219902,1964,766688
172.71.114.122,167.235.145.223,81,2315038,41,3533,40,2311505,1.118962,60.022048,470,308087
172.71.114.124,167.235.145.223,146,1284856,59,5383,87,1279473,75.879876,0.169388,254232,60428035
172.71.114.127,167.235.145.223,387,8451136,176,16370,211,8434766,1.910004,74.340015,1761,907695
172.71.114.128,167.235.145.223,233,3485751,113,9774,120,3475977,14.565544,46.588324,1678,596883
172.71.114.131,167.235.145.223,249,4081948,121,11065,128,4070883,48.346101,5.189626,17057,6275416
172.71.114.133,167.235.145.223,192,6336020,91,8505,101,6327515,26.29531,43.77614,1554,1156340
172.71.114.136,167.235.145.223,6,427,2,132,4,295,22.178623,29.94263,35,78
172.71.114.144,167.235.145.223,187,1362909,82,6901,105,1356008,8.290028,60.085918,918,180542
172.71.114.147,167.235.145.223,212,2069667,85,7088,127,2062579,19.092251,60.084594,943,274623
172.71.114.161,167.235.145.223,363,6098920,179,14551,184,6084369,41.193588,34.894723,3335,1394908
172.71.114.167,167.235.145.223,369,228800,246,114851,123,113949,0.836553,82.093587,11192,11104
172.71.114.168,167.235.145.223,6,427,2,132,4,295,2.929445,29.559433,35,79
172.71.114.171,167.235.145.223,6,427,2,132,4,295,9.567384,29.931367,35,78
172.71.114.173,167.235.145.223,132,4307013,64,6621,68,4300392,13.94685,50.432144,1050,682166
172.71.114.174,167.235.145.223,228,138532,152,68124,76,70408,0.125031,82.879916,6575,6796
172.71.114.175,167.235.145.223,450,275259,300,136217,150,139042,1.219625,81.151767,13428,13706
172.71.114.179,167.235.145.223,171,4482953,74,6538,97,4476415,7.064108,48.133764,1086,743995
172.71.114.181,167.235.145.223,218,1771718,93,7616,125,1764102,31.095604,30.340946,2008,465140
172.71.114.185,167.235.145.223,715,4103089,433,175156,282,3927933,0.520181,82.156805,17055,382481
172.71.114.196,167.235.145.223,184,115426,123,58924,61,56502,0.01426,79.16881,5954,5709
172.71.114.198,167.235.145.223,376,6000151,167,13935,209,5986216,5.190401,51.562534,2162,928769
172.71.114.209,167.235.145.223,169,1307490,82,6901,87,1300589,16.493145,52.723076,1047,197346
172.71.114.210,167.235.145.223,6,427,2,132,4,295,28.298765,29.79825,35,79
172.71.114.216,167.235.145.223,618,377858,412,186998,206,190860,0.284374,82.000405,18243,18620
172.71.115.23,167.235.145.223,171,1314265,108,45205,63,1269060,0.435198,81.250163,4450,124953
172.71.115.24,167.235.145.223,341,2624658,215,86513,126,2538145,0.259828,82.291221,8410,246747
172.71.115.33,167.235.145.223,144,88293,96,43829,48,44464,0.816765,80.093804,4377,4441
172.71.115.34,167.235.145.223,285,176020,190,87869,95,88151,1.236303,80.277632,8756,8784
172.71.115.35,167.235.145.223,295,4804806,135,10913,160,4793893,65.220373,2.7382,31883,14005968
172.71.115.37,167.235.145.223,172,5178813,89,7226,83,5171587,19.443235,60.543972,954,683349
172.71.115.60,167.235.145.223,6,427,2,132,4,295,7.336773,29.816837,35,79
172.71.115.62,167.235.145.223,250,2780299,106,8474,144,2771825,25.118654,30.219474,2243,733785
172.71.122.26,167.235.145.223,596,10771745,271,23111,325,10748634,24.949349,56.178829,3291,1530631
172.71.122.30,167.235.145.223,341,7018582,161,14796,180,7003786,0.171542,62.552902,1892,895726
172.71.122.33,167.235.145.223,302,4879415,135,11212,167,4868203,65.227342,3.017021,29729,12908635
172.71.122.51,167.235.145.223,198,2666835,88,8105,110,2658730,12.164153,69.589043,931,305649
172.71.122.52,167.235.145.223,198,2883786,83,7775,115,2876011,29.922059,30.277319,2054,759911
172.71.122.59,167.235.145.223,6,427,2,132,4,295,12.096961,29.939271,35,78
172.71.122.66,167.235.145.223,96,60631,64,30990,32,29641,1.446718,76.438327,3243,3102
172.71.122.67,167.235.145.223,96,60860,64,31215,32,29645,5.114417,74.355052,3358,3189
172.71.122.70,167.235.145.223,6,427,2,132,4,295,24.522277,29.705088,35,79
172.71.122.97,167.235.145.223,253,4237384,107,9364,146,4228020,35.235978,32.981822,2271,1025539
172.71.122.99,167.235.145.223,6,427,2,132,4,295,6.347899,29.898393,35,78
172.71.122.105,167.235.145.223,6,427,2,132,4,295,12.712919,29.551446,35,79
172.71.122.119,167.235.145.223,6,427,2,132,4,295,6.023133,29.973757,35,78
172.71.122.121,167.235.145.223,238,2318506,114,9065,124,2309441,80.661239,0.18035,402107,102442628
172.71.122.124,167.235.145.223,280,9642683,123,11179,157,9631504,0.332231,77.169765,1158,998474
172.71.122.127,167.235.145.223,205,2323775,96,8633,109,2315142,35.962509,30.501764,2264,607215
172.71.122.134,167.235.145.223,6,427,2,132,4,295,26.436132,29.956478,35,78
172.71.122.148,167.235.145.223,284,4125114,133,11302,151,4113812,20.644592,34.061636,2654,966204
172.71.122.154,167.235.145.223,227,7283152,110,10779,117,7272373,6.170164,73.613794,1171,790327
172.71.122.157,167.235.145.223,6,427,2,132,4,295,20.688935,29.938768,35,78
172.71.122.159,167.235.145.223,6,427,2,132,4,295,2.536956,29.422437,35,80
172.71.122.170,167.235.145.223,286,4311878,137,11353,149,4300525,58.915221,3.299613,27525,10426737
172.71.122.175,167.235.145.223,6,427,2,132,4,295,26.679632,29.96736,35,78
172.71.122.190,167.235.145.223,7,493,3,198,4,295,20.242206,29.99144,52,78
172.71.122.193,167.235.145.223,7,493,3,198,4,295,0.328959,29.704531,53,79
172.71.122.195,167.235.145.223,322,2542768,184,49448,138,2493320,1.00853,79.476616,4977,250973
172.71.122.200,167.235.145.223,42,27022,28,14042,14,12980,2.506656,78.044294,1439,1330
172.71.122.201,167.235.145.223,42,26843,28,13874,14,12969,1.586033,78.033042,1422,1329
172.71.122.202,167.235.145.223,304,4759275,147,12226,157,4747049,43.000325,31.715942,3083,1197391
172.71.122.206,167.235.145.223,126,76172,84,37268,42,38904,0.091909,80.721696,3693,3855
172.71.122.212,167.235.145.223,126,80053,84,41146,42,38907,0.088778,80.898987,4068,3847
172.71.122.216,167.235.145.223,108,68057,72,34702,36,33355,1.647452,79.577153,3488,3353
172.71.122.217,167.235.145.223,105,66031,70,33530,35,32501,2.912633,78.066963,3436,3330
172.71.122.218,167.235.145.223,153,2104916,92,29264,61,2075652,1.343797,78.921169,2966,210402
172.71.122.225,167.235.145.223,290,4492992,135,11212,155,4481780,5.232302,62.976056,1424,569331
172.71.122.226,167.235.145.223,265,5079950,124,12164,141,5067786,41.529014,36.885711,2638,1099132
172.71.122.231,167.235.145.223,422,8934239,202,17377,220,8916862,73.608487,6.08673,22839,11719740
172.71.122.238,167.235.145.223,207,2781935,99,8831,108,2773104,54.045067,0.233214,302932,95126501
172.71.122.242,167.235.145.223,319,4645760,153,12622,166,4633138,0.177571,62.459194,1616,593429
172.71.122.248,167.235.145.223,308,4890769,145,11872,163,4878897,47.237743,32.99365,2878,1182990
172.71.123.24,167.235.145.223,184,2171699,90,8237,94,2163462,60.034942,0.168035,392156,103000541
172.71.123.25,167.235.145.223,6,427,2,132,4,295,18.311175,29.919853,35,78
172.71.123.42,167.235.145.223,193,2521858,91,8303,102,2513555,18.17538,36.200876,1834,555468
172.71.123.48,167.235.145.223,285,4070757,135,11212,150,4059545,41.232245,33.088852,2710,981489
172.71.123.51,167.235.145.223,6,427,2,132,4,295,14.20703,29.945684,35,78
172.71.123.64,167.235.145.223,319,5344451,150,12072,169,5332379,71.244269,2.500358,38624,17061169
172.71.123.73,167.235.145.223,263,3527101,128,10972,135,3516129,30.630948,32.040765,2739,877913
172.71.123.100,167.235.145.223,197,2594430,89,8171,108,2586259,65.94787,0.243447,268510,84987993
172.71.123.128,167.235.145.223,279,4588665,127,10684,152,4577981,23.230977,33.117006,2580,1105892
172.71.123.133,167.235.145.223,305,4837452,147,12013,158,4825439,52.582337,3.62377,26520,10652859
172.71.123.142,167.235.145.223,218,4155057,119,40848,99,4114209,0.047007,80.734379,4047,407678
172.71.123.145,167.235.145.223,114,69236,76,33952,38,35284,2.037525,79.342569,3423,3557
172.71.123.146,167.235.145.223,117,71731,78,35606,39,36125,0.161466,81.473337,3496,3547
172.71.123.151,167.235.145.223,111,70021,74,35751,37,34270,0.425762,78.693055,3634,3483
172.71.123.154,167.235.145.223,374,4785411,209,28548,165,4756863,2.827526,77.633534,2941,490186
172.71.123.155,167.235.145.223,129,81806,86,41975,43,39831,1.450455,78.891166,4256,4039
172.71.123.165,167.235.145.223,6,427,2,132,4,295,14.642453,29.994269,35,78
172.71.123.168,167.235.145.223,282,4251582,133,11302,149,4240280,12.629028,62.020987,1457,546947
172.71.123.182,167.235.145.223,304,4969962,144,11806,160,4958156,29.229474,32.990084,2862,1202338
172.71.123.184,167.235.145.223,198,2455897,99,8831,99,2447066,77.99094,0.206227,342573,94927085
172.71.123.200,167.235.145.223,265,4154000,127,10906,138,4143094,55.294583,1.391064,62720,23826906
172.71.123.205,167.235.145.223,237,2904409,118,10085,119,2894324,71.952236,0.24124,334438,95981561
172.71.126.88,167.235.145.223,1152,2320040,539,37205,613,2282835,5.500147,60.072967,4954,304008
172.71.126.106,167.235.145.223,14,4285,7,2072,7,2213,5.443765,66.042235,250,268
172.71.126.167,167.235.145.223,250,2485022,121,9461,129,2475561,11.52693,60.065366,1260,329715
172.71.126.182,167.235.145.223,6,427,2,132,4,295,29.78894,29.905327,35,78
172.71.130.7,167.235.145.223,236,2330322,115,8987,121,2321335,0.650283,60.062855,1197,309187
172.71.130.27,167.235.145.223,221,2070304,109,8715,112,2061589,20.848209,60.063771,1160,274586
172.71.130.39,167.235.145.223,84,2764283,33,3048,51,2761235,17.286906,39.935998,610,553132
172.71.130.50,167.235.145.223,14,986,6,396,8,590,5.390134,29.761891,106,158
172.71.130.56,167.235.145.223,223,2302323,108,8516,115,2293807,23.122718,30.38766,2241,603878
172.71.130.57,167.235.145.223,222,2302527,101,8293,121,2294234,22.992825,60.06289,1104,305577
172.71.130.68,167.235.145.223,249,2494101,126,9943,123,2484158,28.957205,30.151869,2638,659105
172.71.130.69,167.235.145.223,232,2492740,112,8780,120,2483960,29.099089,30.517247,2301,651162
172.71.130.75,167.235.145.223,212,2123939,102,8253,110,2115686,38.858064,30.151557,2189,561347
172.71.130.92,167.235.145.223,286,4070885,138,11472,148,4059413,41.083148,33.009789,2780,983808
172.71.130.96,167.235.145.223,233,2306124,118,9309,115,2296815,72.998831,0.146723,507568,125232717
172.71.130.99,167.235.145.223,6,427,2,132,4,295,1.117093,29.584077,35,79
172.71.130.112,167.235.145.223,6,427,2,132,4,295,6.813292,29.907787,35,78
172.71.130.124,167.235.145.223,161,4937433,79,6927,82,4930506,10.931965,60.179967,920,655434
172.71.130.143,167.235.145.223,139,1091357,65,5602,74,1085755,72.062774,0.134801,332460,64436020
172.71.130.146,167.235.145.223,217,2316976,103,8195,114,2308781,81.716822,0.148477,441549,124398041
172.71.130.179,167.235.145.223,175,1768923,79,6735,96,1762188,32.865784,30.213061,1783,466602
172.71.130.189,167.235.145.223,6,427,2,132,4,295,11.209072,29.881181,35,78
172.71.130.194,167.235.145.223,296,4240284,143,11802,153,4228482,35.081575,31.077558,3038,1088497
172.71.130.196,167.235.145.223,226,2386899,109,8591,117,2378308,69.721419,0.190806,360198,99716277
172.71.130.210,167.235.145.223,467,9177983,245,19943,222,9158040,59.108001,6.849521,23292,10696269
172.71.130.224,167.235.145.223,6,427,2,132,4,295,12.795544,29.911349,35,78
172.71.130.227,167.235.145.223,301,4701551,137,11309,164,4690242,44.84318,18.880607,4791,1987326
172.71.130.240,167.235.145.223,6,427,2,132,4,295,29.260429,29.90038,35,78
172.71.130.241,167.235.145.223,6,427,2,132,4,295,29.211655,29.796193,35,79
172.71.130.246,167.235.145.223,232,2426488,111,8723,121,2417765,6.650234,60.065188,1161,322018
172.71.130.250,167.235.145.223,301,4837089,138,11320,163,4825769,53.119266,0.773056,117145,49939657
172.71.130.253,167.235.145.223,7,493,3,198,4,295,19.551345,29.677147,53,79
172.71.131.3,167.235.145.223,144,1221263,69,5866,75,1215397,52.472022,30.443504,1541,319384
172.71.131.11,167.235.145.223,45,26794,30,12885,15,13909,0.607897,81.080756,1271,1372
172.71.131.20,167.235.145.223,243,2134916,129,9911,114,2125005,12.655499,60.065063,1320,283027
172.71.131.25,167.235.145.223,48,31942,32,17120,16,14822,4.851035,75.145756,1822,1577
172.71.131.31,167.235.145.223,288,4354234,141,11670,147,4342564,77.128001,2.980548,31323,11655746
172.71.131.42,167.235.145.223,42,25569,28,12600,14,12969,1.156384,78.059812,1291,1329
172.71.131.57,167.235.145.223,42,26593,28,13616,14,12977,6.81373,73.015861,1491,1421
172.71.131.70,167.235.145.223,163,4708551,81,7059,82,4701492,13.45266,63.69174,886,590530
172.71.131.80,167.235.145.223,337,5345679,167,13234,170,5332445,71.086541,0.607334,174322,70240691
172.71.131.87,167.235.145.223,20,9787,10,2921,10,6866,53.776213,5.755177,4060,9544
172.71.131.101,167.235.145.223,81,46977,54,21962,27,25015,1.015919,82.047741,2141,2439
172.71.131.143,167.235.145.223,6,427,2,132,4,295,7.275863,29.907507,35,78
172.71.131.145,167.235.145.223,225,2224111,104,8261,121,2215850,51.721736,30.410259,2173,582921
172.71.131.170,167.235.145.223,215,2390570,103,8907,112,2381663,13.521982,64.459913,1105,295583
172.71.131.171,167.235.145.223,6,427,2,132,4,295,25.341197,29.906727,35,78
172.71.131.186,167.235.145.223,212,2084624,106,8393,106,2076231,57.713411,0.147248,455992,112801858
172.71.131.189,167.235.145.223,227,2254403,108,8516,119,2245887,5.093076,60.064504,1134,299130
172.71.131.190,167.235.145.223,244,2255764,127,10009,117,2245755,4.982803,60.065912,1333,299105
172.71.131.196,167.235.145.223,6,427,2,132,4,295,1.252001,29.912944,35,78
172.71.134.30,167.235.145.223,236,2426724,112,8761,124,2417963,8.45024,60.061893,1166,322062
172.71.134.47,167.235.145.223,343,6523003,156,13612,187,6509391,76.653092,3.30898,32909,15737516
172.71.134.57,167.235.145.223,230,2387134,112,8761,118,2378373,44.614938,30.150427,2324,631068
172.71.134.71,167.235.145.223,240,3885654,114,10883,126,3874771,66.194346,1.781454,48872,17400487
172.71.134.87,167.235.145.223,6,427,2,132,4,295,20.64234,29.899586,35,78
172.71.134.95,167.235.145.223,673,10103888,253,21263,420,10082625,47.079559,33.749718,5040,2389975
172.71.134.102,167.235.145.223,135,4477649,61,5700,74,4471949,5.058879,61.479638,741,581909
172.71.134.103,167.235.145.223,216,2253929,100,8240,116,2245689,6.531199,60.060866,1097,299121
172.71.134.104,167.235.145.223,117,3691534,55,6270,62,3685264,2.627848,65.870016,761,447580
172.71.134.106,167.235.145.223,258,3778342,124,11475,134,3766867,18.058376,63.382252,1448,475447
172.71.134.113,167.235.145.223,206,2385550,88,7177,118,2378373,68.635631,0.140543,408529,135381940
172.71.134.123,167.235.145.223,183,2171707,92,8444,91,2163263,58.916653,1.279153,52809,13529346
172.71.134.129,167.235.145.223,220,2782868,106,9368,114,2773500,53.969494,0.246444,304101,90032624
172.71.134.130,167.235.145.223,368,7503057,164,14470,204,7488587,53.09524,1.651215,70105,36281584
172.71.134.143,167.235.145.223,393,6515112,197,16254,196,6498858,59.163925,1.747842,74395,29745745
172.71.134.144,167.235.145.223,237,147580,158,74702,79,72878,0.47723,80.949946,7382,7202
172.71.134.145,167.235.145.223,471,297698,314,152558,157,145140,0.820474,82.27152,14834,14113
172.71.134.146,167.235.145.223,225,142773,150,73298,75,69475,1.057574,79.591965,7367,6983
172.71.134.147,167.235.145.223,228,144409,152,74003,76,70406,0.340982,82.037862,7216,6865
172.71.134.148,167.235.145.223,321,198915,214,99784,107,99131,0.865466,80.447274,9922,9857
172.71.134.149,167.235.145.223,223,2217793,132,52353,91,2165440,0.201191,81.875238,5115,211584
172.71.134.150,167.235.145.223,428,2341675,271,121124,157,2220551,0.254999,80.927147,11973,219511
172.71.134.151,167.235.145.223,502,4451187,311,122237,191,4328950,0.287159,81.500861,11998,424923
172.71.134.152,167.235.145.223,345,209265,230,102946,115,106319,1.179149,81.35142,10123,10455
172.71.134.172,167.235.145.223,374,7447146,167,14334,207,7432812,28.950989,31.639515,3624,1879374
172.71.134.174,167.235.145.223,249,3994672,118,11079,131,3983593,12.083367,62.380323,1420,510878
172.71.134.178,167.235.145.223,381,7076745,187,15353,194,7061392,16.224354,62.811329,1955,899378
172.71.134.182,167.235.145.223,6,427,2,132,4,295,18.912418,29.530668,35,79
172.71.134.186,167.235.145.223,566,2522060,363,159779,203,2362281,0.746563,81.897932,15607,230753
172.71.134.187,167.235.145.223,255,157779,170,78945,85,78834,0.044333,81.923637,7709,7698
172.71.134.190,167.235.145.223,6,427,2,132,4,295,27.12934,29.548457,35,79
172.71.134.207,167.235.145.223,168,1201627,89,7051,79,1194576,66.642285,0.133007,424097,71850413
172.71.134.212,167.235.145.223,193,2068303,81,6715,112,2061588,20.459147,60.061242,894,274598
172.71.134.222,167.235.145.223,256,4347716,124,11543,132,4336173,72.253753,1.647923,56036,21050367
172.71.134.228,167.235.145.223,207,2884387,98,8772,109,2875615,30.088266,32.504213,2158,707751
172.71.134.240,167.235.145.223,97,2765122,51,4248,46,2760874,26.542396,30.464158,1115,725015
172.71.134.247,167.235.145.223,224,2124578,104,8233,120,2116345,38.463554,30.486482,2160,555353
172.71.134.249,167.235.145.223,74,2418462,32,3765,42,2414697,24.647205,50.175422,600,385000
172.71.134.252,167.235.145.223,533,7321500,239,18566,294,7302934,65.167837,2.813511,52790,20765325
172.71.134.254,167.235.145.223,75,2052643,36,3365,39,2049278,0.391338,60.019671,448,273147
172.71.135.2,167.235.145.223,218,2067033,103,8254,115,2058779,0.435982,60.060309,1099,274228
172.71.135.5,167.235.145.223,7,493,3,198,4,295,20.554841,29.925343,52,78
172.71.135.9,167.235.145.223,338,5126086,170,15633,168,5110453,0.005338,56.709602,2205,720929
172.71.135.27,167.235.145.223,284,4398899,133,10865,151,4388034,2.613823,53.889141,1612,651416
172.71.135.36,167.235.145.223,180,1769101,83,6847,97,1762254,32.632714,30.300549,1807,465273
172.71.135.47,167.235.145.223,7,493,3,198,4,295,8.808269,29.853229,53,79
172.71.135.51,167.235.145.223,278,4588427,124,10314,154,4578113,22.812387,30.394198,2714,1204996
172.71.135.52,167.235.145.223,199,2300902,84,7064,115,2293838,22.958582,60.067948,940,305499
172.71.135.61,167.235.145.223,337,2913213,206,80675,131,2832538,0.421062,82.66984,7806,274106
172.71.135.63,167.235.145.223,258,160835,172,81151,86,79684,1.710792,79.869658,8128,7981
172.71.135.64,167.235.145.223,129,80102,86,40265,43,39837,1.578588,78.808369,4087,4043
172.71.135.65,167.235.145.223,189,117959,126,59519,63,58440,1.087893,80.174595,5938,5831
172.71.135.66,167.235.145.223,189,117223,126,59321,63,57902,0.05876,80.731022,5878,5737
172.71.135.71,167.235.145.223,627,8642415,342,110588,285,8531827,0.258823,80.494608,10990,847940
172.71.135.73,167.235.145.223,489,8324095,268,88787,221,8235308,0.12225,80.754393,8795,815837
172.71.135.74,167.235.145.223,258,160354,172,80669,86,79685,0.013895,81.110436,7956,7859
172.71.135.75,167.235.145.223,6,427,2,132,4,295,12.203375,29.975549,35,78
172.71.135.77,167.235.145.223,223,3676563,105,10221,118,3666342,78.214247,2.33332,35043,12570387
172.71.135.83,167.235.145.223,6,427,2,132,4,295,8.532411,29.962233,35,78
172.71.135.85,167.235.145.223,217,2728341,102,9036,115,2719305,48.167959,32.352621,2234,672416
172.71.135.86,167.235.145.223,6,427,2,132,4,295,0.456695,29.971074,35,78
172.71.135.107,167.235.145.223,576,358000,384,180075,192,177925,0.020084,80.894282,17808,17595
172.71.160.13,167.235.145.223,266,4491210,126,10420,140,4480790,6.173088,61.886984,1346,579222
172.71.160.26,167.235.145.223,306,4590249,146,11740,160,4578509,24.197755,31.906927,2943,1147966
172.71.160.89,167.235.145.223,323,4723986,158,12532,165,4711454,18.199598,61.858432,1620,609320
172.71.160.96,167.235.145.223,7,493,3,198,4,295,20.093226,29.962852,52,78
172.71.160.109,167.235.145.223,42,25135,28,12166,14,12969,1.993757,78.037808,1247,1329
172.71.160.121,167.235.145.223,6,427,2,132,4,295,14.065984,29.996053,35,78
172.71.160.123,167.235.145.223,7,493,3,198,4,295,8.08214,29.964838,52,78
172.71.160.127,167.235.145.223,291,4968905,143,11542,148,4957363,30.217322,31.872882,2897,1244283
172.71.160.131,167.235.145.223,279,4835529,136,11080,143,4824449,54.325146,1.757875,50424,21955822
172.71.160.141,167.235.145.223,119,4223206,47,4555,72,4218651,26.109333,42.432085,858,795370
172.71.182.2,167.235.145.223,366,230930,244,117766,122,113164,0.452639,82.210804,11459,11012
172.71.182.3,167.235.145.223,183,115775,122,59264,61,56511,0.886705,82.150016,5771,5503
172.71.182.9,167.235.145.223,118,4821557,38,5074,80,4816483,0.826521,76.474483,530,503852
172.71.182.15,167.235.145.223,206,2316232,100,7979,106,2308253,80.636917,0.116811,546455,158084632
172.71.182.18,167.235.145.223,235,3868738,109,9653,126,3859085,82.448309,0.174355,442912,177067936
172.71.182.20,167.235.145.223,289,1416825,186,78343,103,1338482,0.571945,81.189518,7719,131887
172.71.182.21,167.235.145.223,252,158320,168,80489,84,77831,0.570841,80.852961,7963,7700
172.71.182.22,167.235.145.223,598,375400,398,190119,200,185281,0.387788,82.714352,18388,17920
172.71.182.23,167.235.145.223,300,190538,200,97821,100,92717,0.015867,81.085961,9651,9147
172.71.182.25,167.235.145.223,378,7420247,184,15334,194,7404913,10.944438,61.574367,1992,962077
172.71.182.28,167.235.145.223,665,412902,443,207199,222,205703,0.35181,82.747483,20031,19887
172.71.182.32,167.235.145.223,77,2310284,38,4248,39,2306036,26.717122,39.424982,861,467933
172.71.182.41,167.235.145.223,199,2222528,93,7668,106,2214860,48.989143,30.256989,2027,585612
172.71.182.45,167.235.145.223,6,427,2,132,4,295,24.466864,29.993067,35,78
172.71.182.46,167.235.145.223,181,2472721,84,7708,97,2465013,5.295768,60.581111,1017,325515
172.71.182.47,167.235.145.223,175,2454390,83,7787,92,2446603,77.404313,0.496338,125511,39434466
172.71.182.51,167.235.145.223,579,10789270,275,23635,304,10765635,53.306505,19.237585,9828,4476917
172.71.182.55,167.235.145.223,6,427,2,132,4,295,24.263904,29.58627,35,79
172.71.182.56,167.235.145.223,318,6521347,145,12877,173,6508470,76.511833,2.022153,50943,25748674
172.71.182.57,167.235.145.223,6,427,2,132,4,295,2.653886,29.940118,35,78
172.71.182.64,167.235.145.223,149,1369306,71,6058,78,1363248,57.514699,0.102985,470592,105898761
172.71.182.72,167.235.145.223,153,96117,102,48872,51,47245,0.955856,79.684727,4906,4743
172.71.182.73,167.235.145.223,306,190588,204,96032,102,94556,0.920274,79.944598,9609,9462
172.71.182.74,167.235.145.223,228,144896,152,74486,76,70410,0.281734,81.350087,7324,6924
172.71.182.75,167.235.145.223,225,141075,150,71587,75,69488,0.414151,80.887133,7080,6872
172.71.182.80,167.235.145.223,543,4555105,335,133847,208,4421258,0.174262,82.711909,12945,427629
172.71.182.81,167.235.145.223,268,2276834,165,66699,103,2210135,0.415474,81.603789,6538,216669
172.71.182.85,167.235.145.223,6,427,2,132,4,295,29.854776,29.997315,35,78
172.71.182.88,167.235.145.223,164,2592263,71,6995,93,2585268,65.369987,0.519636,107690,39801214
172.71.182.92,167.235.145.223,391,9417318,172,15394,219,9401924,36.96531,29.73606,4141,2529433
172.71.182.97,167.235.145.223,180,2900658,77,7391,103,2893267,71.314978,0.585043,101066,39563136
172.71.182.98,167.235.145.223,219,2386570,107,8592,112,2377978,42.971643,30.323606,2266,627360
172.71.182.100,167.235.145.223,6,427,2,132,4,295,21.565147,29.88397,35,78
172.71.182.104,167.235.145.223,191,6715880,82,8103,109,6707777,5.069329,61.438769,1055,873425
172.71.182.108,167.235.145.223,6,427,2,132,4,295,5.845348,29.997434,35,78
172.71.182.111,167.235.145.223,142,1311576,66,5728,76,1305848,71.372642,0.10329,443644,101140323
172.71.182.113,167.235.145.223,6,427,2,132,4,295,29.751232,29.995076,35,78
172.71.182.114,167.235.145.223,125,1169542,52,4816,73,1164726,24.685022,30.143695,1278,309113
172.71.182.119,167.235.145.223,347,7445242,158,13618,189,7431624,28.942172,31.626339,3444,1879856
172.71.182.121,167.235.145.223,461,10782581,219,19479,242,10763102,12.825766,48.171434,3234,1787466
172.71.182.122,167.235.145.223,437,2190904,280,122040,157,2068864,0.734123,81.075459,12042,204142
172.71.182.123,167.235.145.223,501,4864431,302,126104,199,4738327,0.19555,82.329631,12253,460424
172.71.182.124,167.235.145.223,336,210248,224,106486,112,103762,0.564975,80.760906,10548,10278
172.71.182.125,167.235.145.223,336,210150,224,106321,112,103829,0.775137,82.23693,10342,10100
172.71.182.128,167.235.145.223,186,2067945,81,6819,105,2061126,18.906025,60.052298,908,274577
172.71.182.130,167.235.145.223,316,1402299,205,91772,111,1310527,0.38579,80.853549,9080,129669
172.71.182.131,167.235.145.223,315,1402181,204,91664,111,1310517,0.983158,80.572604,9101,130120
172.71.182.134,167.235.145.223,381,9127267,180,15791,201,9111476,11.887917,66.644991,1895,1093732
172.71.182.140,167.235.145.223,142,1245284,67,5794,75,1239490,31.558705,30.188683,1535,328464
172.71.182.152,167.235.145.223,6,427,2,132,4,295,13.278997,29.609848,35,79
172.71.182.155,167.235.145.223,243,2779832,116,9129,127,2770703,24.835624,30.12507,2424,735786
172.71.182.158,167.235.145.223,6,427,2,132,4,295,19.238511,29.647133,35,79
172.71.182.170,167.235.145.223,96,2808177,51,4879,45,2803298,6.550661,53.504168,729,419152
172.71.182.175,167.235.145.223,810,1653314,519,226386,291,1426928,1.037812,81.381637,22254,140270
172.71.182.177,167.235.145.223,517,317306,345,158052,172,159254,0.344345,81.550352,15504,15622
172.71.182.182,167.235.145.223,222,141199,148,72651,74,68548,1.136934,79.353669,7324,6910
172.71.182.183,167.235.145.223,450,284532,300,145583,150,138949,0.567746,81.84976,14229,13580
172.71.182.188,167.235.145.223,130,1199314,60,5332,70,1193982,67.55302,0.105764,403313,90312923
172.71.182.191,167.235.145.223,170,1768545,79,6687,91,1761858,30.835483,30.40524,1759,463566
172.71.182.209,167.235.145.223,449,9790468,220,19566,229,9770902,16.044571,62.125924,2519,1258206
172.71.182.210,167.235.145.223,219,3745164,103,9683,116,3735481,2.607913,69.549286,1113,429678
172.71.182.212,167.235.145.223,316,11725507,131,14172,185,11711335,11.23709,61.342717,1848,1527331
172.71.182.217,167.235.145.223,128,997410,62,5606,66,991804,44.141282,30.424498,1474,260790
172.71.182.224,167.235.145.223,246,153119,164,77161,82,75958,0.840645,80.136591,7702,7582
172.71.182.225,167.235.145.223,246,153054,164,77093,82,75961,1.264762,80.176911,7692,7579
172.71.182.226,167.235.145.223,806,2625179,527,243118,279,2382061,0.039398,82.393718,23605,231285
172.71.182.227,167.235.145.223,183,115827,122,59552,61,56275,0.743483,80.110157,5947,5619
172.71.182.232,167.235.145.223,183,113060,122,56470,61,56590,0.27546,81.244924,5560,5572
172.71.182.233,167.235.145.223,363,225729,242,113552,121,112177,0.469444,82.344597,11031,10898
172.71.182.237,167.235.145.223,7,493,3,198,4,295,12.683811,29.854324,53,79
172.71.182.239,167.235.145.223,6,427,2,132,4,295,17.917626,29.937506,35,78
172.71.182.240,167.235.145.223,292,5006871,137,11668,155,4995203,23.056188,31.496339,2963,1268770
172.71.182.241,167.235.145.223,255,3808385,124,10701,131,3797684,23.152096,49.868738,1716,609228
172.71.182.243,167.235.145.223,7,493,3,198,4,295,7.116299,29.764466,53,79
172.71.182.249,167.235.145.223,195,2083635,94,7734,101,2075901,54.994131,0.116555,530839,142483874
172.71.182.251,167.235.145.223,140,1305428,64,5596,76,1299832,77.775776,0.14925,299953,69672737
172.71.183.3,167.235.145.223,293,4797571,141,11658,152,4785913,6.853084,60.280824,1547,635148
172.71.242.8,167.235.145.223,42,26199,28,13230,14,12969,1.477588,78.044345,1356,1329
172.71.242.11,167.235.145.223,299,2684071,146,11119,153,2672952,73.604474,0.252126,352807,84813212
172.71.242.34,167.235.145.223,7,493,3,198,4,295,7.87525,29.797258,53,79
172.71.242.40,167.235.145.223,6,427,2,132,4,295,20.021927,29.64998,35,79
172.71.242.97,167.235.145.223,244,2186260,107,8545,137,2177715,79.607831,0.243878,280304,71436209
172.71.242.111,167.235.145.223,290,2496663,140,10723,150,2485940,31.585743,30.250532,2835,657427
172.71.242.121,167.235.145.223,42,24956,28,11984,14,12972,2.043443,78.026918,1228,1330
172.71.242.124,167.235.145.223,289,2608096,137,10525,152,2597571,49.588453,30.242884,2784,687122
172.71.242.134,167.235.145.223,262,2069964,124,9667,138,2060297,1.579755,60.101923,1286,274240
172.71.242.138,167.235.145.223,329,4688378,150,12215,179,4676163,7.587316,60.060636,1627,622858
172.71.242.152,167.235.145.223,255,2165901,119,9337,136,2156564,61.590575,0.275202,271422,62690358
172.71.242.156,167.235.145.223,267,2130539,130,10063,137,2120476,37.582025,30.453319,2643,557042
172.71.242.174,167.235.145.223,7,493,3,198,4,295,1.92868,29.77025,53,79
172.71.242.184,167.235.145.223,261,2304926,120,9403,141,2295523,25.606203,30.246336,2487,607154
172.71.242.194,167.235.145.223,275,2486680,125,9733,150,2476947,13.605605,60.097055,1295,329726
172.71.242.197,167.235.145.223,6,427,2,132,4,295,14.03262,29.645582,35,79
172.71.242.208,167.235.145.223,319,4781140,142,11687,177,4769453,19.59747,36.040955,2594,1058674
172.71.242.222,167.235.145.223,6,427,2,132,4,295,26.111877,29.583397,35,79
172.71.242.224,167.235.145.223,253,2045246,116,9139,137,2036107,43.598042,30.508806,2396,533906
172.71.246.4,167.235.145.223,176,2489265,76,6626,100,2482639,31.855751,30.405294,1743,653212
172.71.246.9,167.235.145.223,301,6622682,144,12796,157,6609886,62.532251,4.482143,22839,11797724
172.71.246.14,167.235.145.223,6,427,2,132,4,295,26.030366,29.714921,35,79
172.71.246.21,167.235.145.223,273,5341731,127,10870,146,5330861,71.823,2.976894,29211,14325967
172.71.246.27,167.235.145.223,190,2327344,91,7461,99,2319883,3.392936,60.032182,994,309151
172.71.246.32,167.235.145.223,6,427,2,132,4,295,19.743779,29.610768,35,79
172.71.246.38,167.235.145.223,169,2039829,82,7022,87,2032807,44.204548,30.161494,1862,539179
172.71.246.41,167.235.145.223,175,2299377,84,7154,91,2292223,25.887379,30.229791,1893,606612
172.71.246.50,167.235.145.223,154,2065816,67,5877,87,2059939,21.396902,60.02865,783,274527
172.71.246.52,167.235.145.223,159,2123538,73,6428,86,2117110,38.258529,30.314008,1696,558714
172.71.246.56,167.235.145.223,169,2063953,82,7022,87,2056931,1.655573,60.026905,935,274134
172.71.246.60,167.235.145.223,7,493,3,198,4,295,1.388748,29.655747,53,79
172.71.246.72,167.235.145.223,6,427,2,132,4,295,3.683332,29.735868,35,79
172.71.246.81,167.235.145.223,297,6927379,131,12093,166,6915286,50.120579,31.416546,3079,1760928
172.71.246.88,167.235.145.223,233,4875046,95,8758,138,4866288,67.906885,0.603233,116147,64536097
172.71.246.90,167.235.145.223,178,2221067,86,7131,92,2213936,51.403007,30.393093,1877,582747
172.71.246.92,167.235.145.223,6,427,2,132,4,295,13.393021,29.971419,35,78
172.71.246.101,167.235.145.223,49,1755406,20,2124,29,1753282,9.783217,53.759906,316,260905
172.71.246.107,167.235.145.223,130,2790267,72,16546,58,2773721,3.330655,78.030031,1696,284374
172.71.246.110,167.235.145.223,155,2312942,62,5547,93,2307395,81.420041,0.066157,670768,279020511
172.71.246.111,167.235.145.223,6,427,2,132,4,295,7.866108,29.515411,35,79
172.71.246.117,167.235.145.223,243,6703608,126,21191,117,6682417,3.745191,73.99577,2291,722464
172.71.246.127,167.235.145.223,42,27976,28,15008,14,12968,1.328141,79.131098,1517,1311
172.71.246.129,167.235.145.223,85,2224304,43,3797,42,2220507,19.923552,60.006876,506,296033
172.71.246.130,167.235.145.223,7,493,3,198,4,295,15.447635,29.97086,52,78
172.71.246.136,167.235.145.223,6,427,2,132,4,295,27.879454,29.547484,35,79
172.71.246.137,167.235.145.223,180,2383921,86,7131,94,2376790,69.416871,0.057568,990967,330293218
172.71.246.139,167.235.145.223,246,4833735,113,9946,133,4823789,56.551868,9.496171,8378,4063776
172.71.246.145,167.235.145.223,126,4519276,53,5118,73,4514158,9.395612,60.179177,680,600095
172.71.246.149,167.235.145.223,199,2482735,97,8024,102,2474711,13.979195,60.029354,1069,329800
172.71.250.4,167.235.145.223,312,7069386,141,12609,171,7056777,31.487963,36.046964,2798,1566129
172.71.250.11,167.235.145.223,127,1455294,62,5527,65,1449767,75.091467,0.053224,830753,217911769
172.71.250.14,167.235.145.223,6,427,2,132,4,295,13.657454,29.857897,35,79
172.71.250.20,167.235.145.223,192,2300423,96,7871,96,2292552,25.522599,30.054274,2095,610243
172.71.250.27,167.235.145.223,7,493,3,198,4,295,25.638072,29.879428,53,78
172.71.250.31,167.235.145.223,192,3248018,87,8061,105,3239957,43.501048,31.688047,2035,817963
172.71.250.32,167.235.145.223,162,2063416,74,6419,88,2056997,1.493464,60.027058,855,274142
172.71.250.45,167.235.145.223,47,1230965,23,2302,24,1228663,17.683119,60.009375,306,163796
172.71.250.51,167.235.145.223,124,1337612,58,5263,66,1332349,19.624408,60.025198,701,177571
172.71.250.53,167.235.145.223,11,2453,5,1166,6,1287,19.16254,60.006055,155,171
172.71.250.64,167.235.145.223,36,22708,24,11592,12,11116,5.184373,75.009688,1236,1185
172.71.250.67,167.235.145.223,259,3526151,134,23347,125,3502804,1.429774,78.048649,2393,359038
172.71.250.71,167.235.145.223,170,2124188,84,7079,86,2117109,37.491803,30.27199,1870,559489
172.71.250.76,167.235.145.223,110,1164911,53,4933,57,1159978,39.274339,30.288314,1302,306382
172.71.250.85,167.235.145.223,182,2366058,84,7050,98,2359008,19.2373,60.029124,939,314381
172.71.250.103,167.235.145.223,116,1300899,56,5131,60,1295768,69.207277,0.055077,745283,188211848
172.71.250.111,167.235.145.223,119,1264973,57,5197,62,1259776,20.464958,60.024457,692,167901
172.71.250.113,167.235.145.223,207,2482244,102,8267,105,2473977,13.486373,60.025239,1101,329724
172.71.250.115,167.235.145.223,129,1446402,63,5593,66,1440809,33.40393,30.124791,1485,382624
172.71.250.116,167.235.145.223,6,427,2,132,4,295,8.00297,29.512444,35,79
172.71.250.117,167.235.145.223,113,1231401,56,5131,57,1226270,81.484113,0.048673,843342,201552400
172.71.250.123,167.235.145.223,48,27870,29,11734,19,16136,17.392973,60.161815,1560,2145
172.71.250.126,167.235.145.223,180,2251448,84,7079,96,2244369,7.492776,60.025958,943,299119
172.71.250.131,167.235.145.223,114,1198352,53,4933,61,1193419,17.895303,60.030243,657,159042
172.71.250.132,167.235.145.223,110,1393925,51,4801,59,1389124,57.423231,0.050175,765480,221484643
172.71.250.134,167.235.145.223,266,5340841,121,10046,145,5330795,73.521363,0.119831,670677,355887541
172.71.250.138,167.235.145.223,6,427,2,132,4,295,1.775661,29.749189,35,79
172.71.250.142,167.235.145.223,201,3827163,102,9051,99,3818112,27.005754,52.845481,1370,578003
172.71.250.146,167.235.145.223,169,2181361,80,6815,89,2174546,79.531554,0.053575,1017638,324710555
172.71.250.149,167.235.145.223,124,1367719,60,5395,64,1362324,51.04928,30.233429,1427,360481
172.71.254.9,167.235.145.223,42,26395,28,13426,14,12969,0.967354,78.257518,1372,1325
172.71.254.64,167.235.145.223,774,2528621,374,26181,400,2502440,31.160729,31.313814,6688,639319
172.71.254.97,167.235.145.223,7,493,3,198,4,295,1.510997,29.723021,53,79
172.71.254.102,167.235.145.223,716,2595748,339,23871,377,2571877,49.197981,31.215869,6117,659120
172.71.254.113,167.235.145.223,828,2167579,409,28491,419,2139088,37.187044,31.607318,7211,541415
172.71.254.126,167.235.145.223,7,493,3,198,4,295,14.572205,29.070477,54,81
172.71.254.128,167.235.145.223,7,493,3,198,4,295,20.592573,29.06246,54,81
172.71.254.130,167.235.145.223,707,2075224,328,23145,379,2052079,43.238244,31.359088,5904,523504
172.71.254.168,167.235.145.223,6,427,2,132,4,295,8.677903,29.005096,36,81
172.71.254.170,167.235.145.223,806,2340910,392,27369,414,2313541,25.182139,31.417855,6969,589102
172.71.254.172,167.235.145.223,736,2480905,359,25191,377,2455714,67.214516,1.185977,169925,16565002
172.71.254.177,167.235.145.223,757,2403999,354,24861,403,2379138,19.15076,60.487401,3288,314662
172.71.254.186,167.235.145.223,705,2195614,340,23937,365,2171677,61.218751,1.22088,156850,14230240
172.71.254.192,167.235.145.223,690,2215710,331,23343,359,2192367,79.255439,1.214917,153709,14436324
172.71.254.200,167.235.145.223,6,427,2,132,4,295,26.505535,29.104899,36,81
172.71.254.208,167.235.145.223,804,2717416,415,28887,389,2688529,73.237198,1.210247,190949,17771770
172.71.254.238,167.235.145.223,771,2462131,372,26049,399,2436082,55.20181,1.304633,159732,14938036
172.71.254.240,167.235.145.223,740,2517383,356,24993,384,2492390,13.140972,60.443772,3307,329878
172.71.255.11,167.235.145.223,761,2289755,350,24597,411,2265158,7.156036,60.531034,3250,299371
172.71.255.17,167.235.145.223,756,2102581,358,25125,398,2077456,1.140711,60.53193,3320,274560
177.201.236.14,167.235.145.223,27,4722,12,2050,15,2672,55.731998,5.692171,2881,3755
180.101.88.253,167.235.145.223,13,2883,6,1275,7,1608,52.081759,12.984532,785,990
183.136.225.32,167.235.145.223,2,112,1,58,1,54,3.072355,2.50E-05,,
185.233.19.199,167.235.145.223,3,170,2,116,1,54,22.197644,0.206474,4494,2092
186.75.154.14,167.235.145.223,28,4776,14,2182,14,2594,67.552879,3.365239,5187,6166
188.114.102.5,167.235.145.223,6,427,2,132,4,295,8.421256,29.990317,35,78
188.114.102.14,167.235.145.223,239,2387716,115,8946,124,2378770,68.167899,0.172663,414495,110215622
188.114.102.15,167.235.145.223,316,4759869,146,11962,170,4747907,68.09475,1.212572,78919,31324536
188.114.102.18,167.235.145.223,334,7739406,152,14714,182,7724692,5.025087,57.718843,2039,1070664
188.114.102.21,167.235.145.223,900,9266862,426,33888,474,9232974,70.76446,2.151966,125979,34323865
188.114.102.23,167.235.145.223,176,1247629,77,6555,99,1241074,29.606527,30.44588,1722,326106
188.114.102.28,167.235.145.223,6,427,2,132,4,295,5.889242,29.569193,35,79
188.114.102.40,167.235.145.223,372,13767196,151,15012,221,13752184,7.980664,73.453618,1634,1497781
188.114.102.46,167.235.145.223,6,427,2,132,4,295,7.404927,29.658985,35,79
188.114.102.47,167.235.145.223,177,1235658,83,6946,94,1228712,77.538209,0.199586,278416,49250428
188.114.102.49,167.235.145.223,6,427,2,132,4,295,19.73662,29.631963,35,79
188.114.102.55,167.235.145.223,249,2670032,120,10048,129,2659984,11.120796,61.090458,1315,348333
188.114.102.57,167.235.145.223,320,6096485,133,11917,187,6084568,41.138855,31.219141,3053,1559189
188.114.102.67,167.235.145.223,57,2507651,16,2607,41,2505044,16.475303,44.894523,464,446387
188.114.102.69,167.235.145.223,211,6328247,110,9757,101,6318490,13.993424,54.976172,1419,919451
188.114.102.72,167.235.145.223,370,7739392,164,13963,206,7725429,47.122594,31.263152,3573,1976877
188.114.102.74,167.235.145.223,6,427,2,132,4,295,24.9008,29.799482,35,79
188.114.102.80,167.235.145.223,723,450253,482,226992,241,223261,0.027632,81.237832,22353,21985
188.114.102.81,167.235.145.223,366,226121,244,113024,122,113097,0.36927,80.928193,11172,11179
188.114.102.86,167.235.145.223,241,2904596,111,9515,130,2895081,6.174588,71.541241,1064,323738
188.114.102.90,167.235.145.223,6,427,2,132,4,295,0.807378,29.884633,35,78
188.114.102.92,167.235.145.223,816,503345,544,251185,272,252160,0.312974,82.417862,24381,24476
188.114.102.96,167.235.145.223,177,1277716,76,6372,101,1271344,52.791727,30.206852,1687,336703
188.114.102.98,167.235.145.223,7,493,3,198,4,295,18.237899,29.960817,52,78
188.114.102.103,167.235.145.223,399,7132269,190,15688,209,7116581,43.153384,31.863615,3938,1786760
188.114.102.106,167.235.145.223,557,338066,368,165361,189,172705,0.16636,82.900942,15957,16666
188.114.102.107,167.235.145.223,705,430744,470,213660,235,217084,0.118518,81.376675,21004,21341
188.114.102.112,167.235.145.223,210,2884282,98,8468,112,2875814,29.210392,37.502892,1806,613459
188.114.102.119,167.235.145.223,231,1944353,102,8212,129,1936141,82.8461,0.246248,266787,62900523
188.114.102.125,167.235.145.223,194,2467483,84,7659,110,2459824,23.482904,30.716405,1994,640654
188.114.102.140,167.235.145.223,209,2162960,93,7716,116,2155244,60.307008,0.213274,289430,80844134
188.114.102.141,167.235.145.223,297,4312286,142,11365,155,4300921,58.331521,1.979038,45941,17385905
188.114.102.143,167.235.145.223,6,427,2,132,4,295,29.905219,29.965009,35,78
188.114.102.146,167.235.145.223,777,476671,518,236719,259,239952,0.539477,82.348698,22996,23310
188.114.102.147,167.235.145.223,419,1561561,273,117890,146,1443671,0.63149,80.887185,11659,142783
188.114.102.148,167.235.145.223,861,15272087,396,32416,465,15239671,1.786374,55.046932,4711,2214789
188.114.102.150,167.235.145.223,235,2729508,108,9411,127,2720097,45.779139,7.697167,9781,2827114
188.114.102.160,167.235.145.223,551,3887620,326,98795,225,3788825,0.693759,80.758898,9786,375322
188.114.102.161,167.235.145.223,741,6367997,454,184495,287,6183502,0.943803,80.499114,18335,614516
188.114.102.164,167.235.145.223,367,6226105,174,14632,193,6211473,55.15273,2.197827,53259,22609506
188.114.102.168,167.235.145.223,359,6621030,157,13632,202,6607398,76.180707,2.665636,40911,19829858
188.114.102.175,167.235.145.223,1123,7396554,704,287543,419,7109011,0.127832,81.713956,28151,695989
188.114.102.177,167.235.145.223,207,2594982,99,8723,108,2586259,65.306872,8.666236,8052,2387434
188.114.102.180,167.235.145.223,428,6736233,211,16843,217,6719390,5.139542,60.863099,2213,883213
188.114.102.188,167.235.145.223,372,6353021,177,14819,195,6338202,34.656153,31.704891,3739,1599299
188.114.102.194,167.235.145.223,216,2728095,104,8988,112,2719107,47.171921,31.13547,2309,698651
188.114.102.196,167.235.145.223,187,2437051,86,7959,101,2429092,52.23265,2.061961,30879,9424395
188.114.102.198,167.235.145.223,447,7560321,212,17242,235,7543079,28.850094,31.442026,4386,1919234
188.114.102.200,167.235.145.223,134,997607,61,5341,73,992266,44.728755,30.339647,1408,261642
188.114.102.201,167.235.145.223,6,427,2,132,4,295,13.572859,29.985459,35,78
188.114.102.203,167.235.145.223,6,427,2,132,4,295,17.859826,29.961051,35,78
188.114.102.207,167.235.145.223,7,493,3,198,4,295,5.867803,29.996576,52,78
188.114.102.209,167.235.145.223,159,1201434,71,6264,88,1195170,58.158055,0.160392,312434,59612449
188.114.102.228,167.235.145.223,181,1362339,84,6859,97,1355480,22.70928,60.073805,913,180508
188.114.102.231,167.235.145.223,930,573497,620,286243,310,287254,0.054726,83.050932,27572,27670
188.114.102.234,167.235.145.223,215,2324252,97,8517,118,2315735,34.823568,31.442735,2166,589194
188.114.102.239,167.235.145.223,163,1171455,69,6027,94,1165428,27.675356,30.423554,1584,306454
188.114.102.241,167.235.145.223,197,6164627,86,8165,111,6156462,20.039127,60.456712,1080,814660
188.114.102.242,167.235.145.223,528,6901721,233,19061,295,6882660,74.012177,1.54577,98648,35620616
188.114.102.246,167.235.145.223,387,238044,258,118458,129,119586,0.89893,81.148231,11678,11789
188.114.103.3,167.235.145.223,366,6876988,163,13908,203,6863080,23.13321,31.253328,3560,1756761
188.114.103.5,167.235.145.223,7,493,3,198,4,295,0.025702,29.980166,52,78
188.114.103.12,167.235.145.223,39,1188129,16,1703,23,1186426,0.173498,60.015835,227,158148
188.114.103.13,167.235.145.223,497,7255996,209,16714,288,7239282,52.303951,1.969165,67902,29410565
192.241.216.16,167.235.145.223,2,108,1,54,1,54,47.181865,1.60E-05,,
192.241.219.26,167.235.145.223,2,108,1,54,1,54,42.311329,1.40E-05,,
193.163.125.61,167.235.145.223,2,112,1,58,1,54,79.4973,1.60E-05,,
195.130.73.227,167.235.145.223,41094,154546175,30392,153823543,10702,722632,0.969393,81.078957,15177653,71301
198.41.230.6,167.235.145.223,1039,2124242,487,33613,552,2090629,21.696557,60.887251,4416,274688
198.41.230.33,167.235.145.223,958,1820551,473,32689,485,1787862,33.712539,32.286833,8099,442994
198.41.230.42,167.235.145.223,1033,2382967,479,33085,554,2349882,63.719694,2.520222,105022,7459285
198.41.230.51,167.235.145.223,45,3001,41,2706,4,295,0.206353,58.418396,370,40
198.41.230.60,167.235.145.223,1119,2364550,546,37507,573,2327043,75.724616,2.51494,119309,7402301
198.41.230.91,167.235.145.223,117,230877,35,3781,82,227096,81.717678,1.341861,22541,1353916
198.41.230.112,167.235.145.223,1328,2296983,652,44503,676,2252480,51.713938,2.545439,139867,7079266
198.41.230.129,167.235.145.223,1118,2388608,546,37507,572,2351101,3.712265,60.893767,4927,308879
198.41.230.130,167.235.145.223,7,493,3,198,4,295,12.2876,28.345888,55,83
198.41.230.149,167.235.145.223,1055,2140336,512,35263,543,2105073,57.71338,2.505998,112571,6720110
198.41.230.153,167.235.145.223,1026,2831509,429,29785,597,2801724,27.716708,32.604424,7308,687446
198.41.230.154,167.235.145.223,6,427,2,132,4,295,24.113633,28.459258,37,82
198.41.230.180,167.235.145.223,1058,2179725,501,34537,557,2145188,39.739267,32.54902,8488,527251
198.41.230.187,167.235.145.223,7,493,3,198,4,295,6.240627,28.379632,55,83
198.41.230.190,167.235.145.223,7,493,3,198,4,295,18.195443,28.410689,55,83
198.41.230.212,167.235.145.223,1094,2191156,543,37309,551,2153847,15.709534,60.883055,4902,283014
198.41.230.244,167.235.145.223,1091,2462195,524,46618,567,2415577,3.433272,78.242548,4766,246983
198.41.230.246,167.235.145.223,1094,2444261,518,35659,576,2408602,45.725909,32.550318,8764,591970
198.41.231.18,167.235.145.223,1115,2484840,527,36253,588,2448587,9.702608,60.920084,4760,321547
198.41.242.28,167.235.145.223,297,4878887,144,11608,153,4867279,66.181738,1.902824,48803,20463391
198.41.242.70,167.235.145.223,42,24310,28,11340,14,12970,0.276901,77.872672,1164,1332
198.41.242.74,167.235.145.223,42,26632,28,13664,14,12968,2.079548,78.114687,1399,1328
198.41.242.105,167.235.145.223,236,4067325,112,9496,124,4057829,42.266415,31.840786,2385,1019529
198.41.242.141,167.235.145.223,6,427,2,132,4,295,2.080132,29.97113,35,78
198.41.242.156,167.235.145.223,310,4355425,155,12334,155,4343091,78.403934,1.698705,58086,20453656
198.41.242.157,167.235.145.223,234,4115410,103,8902,131,4106508,0.317297,61.740118,1153,532102
198.41.242.160,167.235.145.223,248,4309163,121,10090,127,4299073,60.191178,1.91155,42227,17991987
198.41.242.175,167.235.145.223,268,4949370,118,9892,150,4939478,12.378662,61.679638,1283,640662
198.41.242.232,167.235.145.223,276,5190913,126,10420,150,5180493,48.216869,31.868609,2615,1300462
198.41.242.245,167.235.145.223,299,5343063,145,11674,154,5331389,72.187147,1.901697,49109,22427922
216.182.106.149,167.235.145.223,3,162,2,108,1,54,0.108056,0.243374,3550,1775
