Address A,Port A,Address B,Port B,Packets,Bytes,Stream ID,Packets A → B,Bytes A → B,Packets B → A,Bytes B → A,Rel Start,Duration,Bits/s A → B,Bits/s B → A
43.249.73.33,31070,167.235.145.223,443,36,26304,1130,24,14700,12,11604,5.549878,77.228594,1522,1202
43.249.74.22,48768,167.235.145.223,443,2,120,1137,1,66,1,54,5.671122,1.50E-05,,
43.249.74.22,54696,167.235.145.223,443,718,1286510,2126,304,21615,414,1264895,22.637288,2.247058,76953,4503292
43.249.74.23,6622,167.235.145.223,443,291,1709146,1419,173,14543,118,1694603,10.59688,60.232475,1931,225074
43.249.74.24,4566,167.235.145.223,443,713,1325491,3533,294,20955,419,1304536,76.695941,2.25927,74200,4619318
43.249.74.28,31880,167.235.145.223,443,821,1556108,2489,359,25245,462,1530863,28.579439,2.179656,92656,5618732
43.249.74.28,57546,167.235.145.223,443,3,255,2490,2,201,1,54,28.584219,1.20E-05,,
43.249.74.31,45144,167.235.145.223,443,709,1316134,2788,288,20559,421,1295575,40.666806,2.254448,72954,4597400
43.249.74.31,53914,167.235.145.223,443,3,255,2789,2,201,1,54,40.66894,1.00E-05,,
43.249.74.45,31904,167.235.145.223,443,7,5171,3647,3,474,4,4697,82.678889,0.232019,16343,161952
43.249.74.45,43002,167.235.145.223,443,713,1210830,1779,316,22476,397,1188354,16.581455,66.098141,2720,143829
43.249.74.45,61222,167.235.145.223,443,3,255,1778,2,201,1,54,16.575199,4.50E-05,,
43.249.74.50,50568,167.235.145.223,443,728,1368800,1022,296,21087,432,1347713,4.565026,60.913257,2769,177000
43.249.74.52,16370,167.235.145.223,443,3,255,2675,2,201,1,54,34.591078,6.50E-05,,
43.249.74.52,48424,167.235.145.223,443,609,1031625,2674,254,18315,355,1013310,34.591077,2.249289,65140,3604018
43.249.74.61,11948,167.235.145.223,443,42,30688,1010,28,17150,14,13538,4.300551,78.313914,1751,1382
43.249.74.64,2598,167.235.145.223,443,728,1266045,3040,318,22539,410,1243506,52.673961,2.27178,79370,4378966
43.249.74.64,32360,167.235.145.223,443,3,255,3039,2,201,1,54,52.671263,0.000245,,
43.249.74.66,14634,167.235.145.223,443,757,1412964,2915,323,22869,434,1390095,46.634891,2.252138,81234,4937867
43.249.74.67,47612,167.235.145.223,443,2,120,2735,1,66,1,54,37.419931,1.10E-05,,
43.249.74.67,61476,167.235.145.223,443,752,1355206,3272,334,23595,418,1331611,64.647176,2.20287,85688,4835913
43.249.74.69,37600,167.235.145.223,443,697,1239866,3166,293,20889,404,1218977,58.649892,2.244766,74445,4344246
43.249.74.72,9400,167.235.145.223,443,718,1346946,3402,300,21351,418,1325595,70.726995,2.156318,79212,4917994
43.249.74.72,36462,167.235.145.223,443,3,255,3403,2,201,1,54,70.728931,2.60E-05,,
45.143.200.46,55422,167.235.145.223,37312,3,162,3641,2,108,1,54,82.511714,0.035568,24291,12145
46.103.88.74,62725,167.235.145.223,443,243,168344,990,128,53726,115,114618,3.935815,76.638051,5608,11964
46.103.88.74,62728,167.235.145.223,443,14,5755,991,8,994,6,4761,3.943833,0.176292,45106,216050
46.103.88.74,62729,167.235.145.223,443,14,5753,992,8,992,6,4761,3.9462,0.183042,43356,208083
46.103.88.74,62730,167.235.145.223,443,22,10350,998,11,3585,11,6765,4.072908,34.757368,825,1557
46.103.88.74,62731,167.235.145.223,443,221,156180,999,119,47874,102,108306,4.07511,67.915192,5639,12757
46.103.88.74,62733,167.235.145.223,443,14,5729,2762,8,968,6,4761,38.561179,0.147735,52418,257812
46.103.88.74,62734,167.235.145.223,443,14,5729,2764,8,968,6,4761,38.562138,0.151506,51113,251395
46.103.88.74,62735,167.235.145.223,443,14,5729,2763,8,968,6,4761,38.561803,0.147789,52399,257718
46.103.88.74,62736,167.235.145.223,443,13,5845,2766,7,1033,6,4812,38.661671,0.198986,41530,193460
46.103.88.74,62737,167.235.145.223,443,13,5883,2767,7,1071,6,4812,38.664505,0.199138,43025,193313
46.103.88.74,62738,167.235.145.223,443,13,5883,2768,7,1071,6,4812,38.66902,0.212508,40318,181150
60.249.243.247,56010,167.235.145.223,22,26,4644,3035,12,2050,14,2594,52.477526,5.07516,3231,4088
77.90.185.76,46242,167.235.145.223,24458,3,162,3264,2,108,1,54,63.836777,0.014012,61661,30830
78.128.113.150,52629,167.235.145.223,3240,3,162,1369,2,108,1,54,9.21547,0.037047,23321,11660
78.128.113.150,52629,167.235.145.223,3032,3,162,3604,2,108,1,54,80.499511,0.033917,25473,12736
85.73.250.195,54342,167.235.145.223,443,12,5035,1115,6,1842,6,3193,5.387973,60.709497,242,420
85.73.250.195,54350,167.235.145.223,22,116,25864,1818,66,6964,50,18900,17.194012,61.288842,909,2467
85.73.250.195,54353,167.235.145.223,443,49,35634,1153,26,11660,23,23974,6.073431,39.501375,2361,4855
85.73.250.195,54354,167.235.145.223,443,7,422,1711,3,163,4,259,14.973596,30.497928,42,67
104.156.92.21,39410,167.235.145.223,443,52,1331303,1676,27,2875,25,1328428,14.198532,60.024073,383,177052
104.156.92.23,60632,167.235.145.223,443,184,1290593,3509,88,7375,96,1283218,75.293824,0.20714,284831,49559447
104.156.92.24,11076,167.235.145.223,443,131,1169268,2757,63,5693,68,1163575,38.195096,0.138502,328832,67209137
104.156.92.30,20224,167.235.145.223,443,2,120,3445,1,66,1,54,71.788088,9.00E-06,,
104.156.92.32,43666,167.235.145.223,443,138,1269477,2015,66,5891,72,1263586,20.188951,60.064206,784,168298
104.156.92.32,55570,167.235.145.223,443,3,255,2014,2,201,1,54,20.188911,4.00E-05,,
104.156.92.35,28780,167.235.145.223,443,148,1094845,3247,68,6023,80,1088822,62.196646,0.181346,265702,48032909
104.156.92.36,17202,167.235.145.223,443,194,2613007,2883,101,9294,93,2603713,44.218793,12.013429,6189,1733868
104.156.92.41,41520,167.235.145.223,443,2,120,2718,1,66,1,54,36.713703,1.60E-05,,
104.156.92.43,45958,167.235.145.223,443,138,1257339,3655,65,5857,73,1251482,82.90785,0.146999,318750,68108327
104.156.92.46,64988,167.235.145.223,443,139,1372160,3002,67,5957,72,1366203,50.189456,0.139816,340847,78171482
104.156.92.46,65362,167.235.145.223,443,3,255,3003,2,201,1,54,50.189457,4.00E-05,,
104.156.92.49,28740,167.235.145.223,443,143,1315028,3209,72,6319,71,1308709,60.034966,0.149351,338477,70101117
104.156.92.50,23328,167.235.145.223,443,40,23686,3118,24,10898,16,12788,55.63638,27.188399,3206,3762
104.156.92.51,4578,167.235.145.223,443,3,255,845,2,201,1,54,2.192617,3.90E-05,,
104.156.92.51,42458,167.235.145.223,443,196,1206853,848,96,7871,100,1198982,2.199121,60.091334,1047,159621
104.156.92.56,7310,167.235.145.223,443,3,255,1308,2,201,1,54,8.194031,2.30E-05,,
104.156.92.56,53668,167.235.145.223,443,184,1248311,1309,85,7145,99,1241166,8.200833,60.089262,951,165242
104.156.92.61,29582,167.235.145.223,443,140,1305774,3371,70,6155,70,1299619,68.189428,0.139188,353766,74697186
104.156.92.61,39182,167.235.145.223,443,2,120,2656,1,66,1,54,33.866427,1.40E-05,,
104.156.92.62,22180,167.235.145.223,443,147,1203582,3125,75,6517,72,1197065,55.770275,0.13688,380888,69962887
104.156.92.65,55682,167.235.145.223,443,2,120,1756,1,66,1,54,16.210984,2.40E-05,,
104.156.92.68,39198,167.235.145.223,443,170,1461783,3497,89,7409,81,1454374,74.191504,0.140438,422051,82847890
104.156.92.73,30600,167.235.145.223,443,3,255,3599,2,201,1,54,80.190149,8.00E-06,,
104.156.92.73,47432,167.235.145.223,443,143,1236512,3598,72,6287,71,1230225,80.190034,0.143187,351260,68733893
104.156.92.74,37416,167.235.145.223,443,2,120,2783,1,66,1,54,39.936206,2.00E-05,,
104.156.92.78,9514,167.235.145.223,443,141,1308880,3355,69,6121,72,1302759,67.641105,0.143287,341747,72735642
104.156.92.78,36832,167.235.145.223,443,3,255,3356,2,201,1,54,67.64734,3.10E-05,,
104.156.92.79,53302,167.235.145.223,443,60,43440,956,40,24180,20,19260,3.427712,77.846271,2484,1979
104.156.92.80,46990,167.235.145.223,443,182,1453551,2636,83,7013,99,1446538,32.200759,0.209581,267696,55216379
104.156.92.82,44874,167.235.145.223,443,141,1242396,2384,70,6155,71,1236241,26.194147,0.13574,362752,72859348
104.156.92.82,45174,167.235.145.223,443,3,255,2385,2,201,1,54,26.194269,2.10E-05,,
104.156.92.83,59622,167.235.145.223,443,2,120,3262,1,66,1,54,63.734686,1.50E-05,,
104.156.93.20,14466,167.235.145.223,443,2,120,3225,1,66,1,54,61.294837,2.60E-05,,
104.156.93.22,29378,167.235.145.223,443,2,120,3270,1,66,1,54,64.599205,1.10E-05,,
104.156.93.33,55060,167.235.145.223,443,2,120,2982,1,66,1,54,49.229743,1.00E-05,,
104.156.93.36,16136,167.235.145.223,443,2,120,509,1,66,1,54,0.941763,1.70E-05,,
104.156.93.45,43004,167.235.145.223,443,2,120,2654,1,66,1,54,33.695501,1.30E-05,,
104.156.93.56,61852,167.235.145.223,443,2,120,1599,1,66,1,54,13.387982,1.00E-05,,
104.156.93.67,63328,167.235.145.223,443,42,30640,540,28,17150,14,13490,1.004179,77.648214,1766,1389
104.156.93.79,29490,167.235.145.223,443,2,120,2597,1,66,1,54,30.708776,1.20E-05,,
104.156.93.93,42568,167.235.145.223,443,2,120,3654,1,66,1,54,82.850082,7.00E-06,,
104.156.93.99,25836,167.235.145.223,443,2,120,1040,1,66,1,54,4.914503,1.70E-05,,
104.156.93.100,5166,167.235.145.223,443,2,120,3439,1,66,1,54,71.674365,7.00E-06,,
104.156.93.106,36948,167.235.145.223,443,2,120,3513,1,66,1,54,75.842084,1.50E-05,,
104.156.93.107,27154,167.235.145.223,443,2,120,1852,1,66,1,54,17.646674,1.40E-05,,
104.156.93.110,29990,167.235.145.223,443,2,120,3023,1,66,1,54,51.774515,1.80E-05,,
106.12.167.196,59648,167.235.145.223,22,7,1518,1798,5,1336,2,182,16.910716,0.955544,11185,1523
108.162.220.66,14972,167.235.145.223,443,443,2538298,1799,180,14086,263,2524212,16.92997,63.08854,1786,320085
108.162.220.71,33844,167.235.145.223,443,6,427,798,2,132,4,295,1.895472,29.915915,35,78
108.162.220.77,51552,167.235.145.223,443,6,427,2374,2,132,4,295,26.028651,29.964883,35,78
108.162.220.78,36502,167.235.145.223,443,215,2667866,1505,104,9070,111,2658796,11.605233,62.39849,1162,340879
108.162.220.86,17674,167.235.145.223,443,6,427,2317,2,132,4,295,25.451577,29.942922,35,78
108.162.220.88,18616,167.235.145.223,443,1088,2181540,2738,508,34834,580,2146706,37.475399,30.647377,9092,560362
108.162.220.89,29340,167.235.145.223,443,331,2131801,2745,151,11495,180,2120306,37.753604,30.232148,3041,561073
108.162.220.90,42770,167.235.145.223,443,375,231386,196,250,115442,125,115944,0.315569,81.33392,11354,11404
108.162.220.91,28070,167.235.145.223,443,22,11181,268,14,5402,8,5779,0.436525,2.526811,17102,18296
108.162.220.91,31188,167.235.145.223,443,375,232297,379,250,116461,125,115836,0.657631,80.993216,11503,11441
108.162.220.91,54002,167.235.145.223,443,436,2516623,297,277,118576,159,2398047,0.489933,81.100058,11696,236551
108.162.220.91,54018,167.235.145.223,443,375,231017,152,250,115151,125,115866,0.245782,81.361349,11322,11392
108.162.220.91,54026,167.235.145.223,443,516,4803552,356,321,121388,195,4682164,0.605589,81.822762,11868,457785
108.162.220.98,27498,167.235.145.223,443,294,4930721,2831,154,14047,140,4916674,41.713494,32.387717,3469,1214453
108.162.220.100,53384,167.235.145.223,443,6,427,1670,2,132,4,295,14.038433,29.979118,35,78
108.162.220.107,25424,167.235.145.223,443,244,7406350,1286,114,10145,130,7396205,7.877325,65.689915,1235,900741
108.162.220.113,44878,167.235.145.223,443,1312,2850219,2326,624,42490,688,2807729,25.577979,30.753568,11053,730381
108.162.220.113,44886,167.235.145.223,443,1269,2847604,2350,559,38423,710,2809181,25.781609,30.845939,9965,728570
108.162.220.114,27820,167.235.145.223,443,983,7351631,3283,421,31010,562,7320621,65.148996,3.327755,74548,17598942
108.162.221.3,31180,167.235.145.223,443,388,239848,180,258,121141,130,118707,0.296048,62.636842,15472,15161
108.162.221.3,37448,167.235.145.223,443,537,335069,282,358,169528,179,165541,0.457764,82.03575,16532,16143
108.162.221.4,64688,167.235.145.223,443,540,337212,97,360,170450,180,166762,0.160073,82.913411,16446,16090
108.162.221.4,64692,167.235.145.223,443,537,335998,327,358,170478,179,165520,0.550703,82.094795,16612,16129
108.162.221.10,50008,167.235.145.223,443,189,2322697,2711,93,8414,96,2314283,36.163235,31.904176,2109,580308
108.162.221.16,41136,167.235.145.223,443,515,4266620,1607,220,16704,295,4249916,13.474687,60.316875,2215,563678
108.162.221.18,65234,167.235.145.223,443,504,2614661,3318,234,17711,270,2596950,65.702749,2.406907,58867,8631658
108.162.221.24,46054,167.235.145.223,443,862,11300510,557,326,26987,536,11273523,1.042005,77.6842,2779,1160959
108.162.221.28,49000,167.235.145.223,443,287,4619091,3613,132,10832,155,4608259,80.947972,1.658177,52259,22232893
108.162.221.33,41910,167.235.145.223,443,311,4644892,768,150,12084,161,4632808,1.738611,65.715963,1471,563979
108.162.221.35,25408,167.235.145.223,443,237,1327744,955,114,8179,123,1319565,3.411155,60.016471,1090,175893
108.162.221.52,45470,167.235.145.223,443,1331,6524935,3158,619,44148,712,6480787,58.074078,4.105315,86030,12629066
108.162.221.55,37446,167.235.145.223,443,199,2083898,3124,95,7799,104,2076099,55.751676,0.14312,435941,116048015
108.162.221.56,62494,167.235.145.223,443,338,2092849,3120,156,11602,182,2081247,55.661626,0.228276,406595,72937917
108.162.221.59,35208,167.235.145.223,443,955,6771367,1045,463,33828,492,6737539,4.927876,62.297946,4344,865202
108.162.221.61,49032,167.235.145.223,443,998,7117476,1753,393,28957,605,7088519,16.054443,63.48719,3648,893221
108.162.221.63,62884,167.235.145.223,443,354,4118236,359,151,11461,203,4106775,0.615731,60.719327,1510,541083
108.162.221.65,11390,167.235.145.223,443,844,2111206,1961,359,25000,485,2086206,19.624172,60.057408,3330,277894
108.162.221.65,11406,167.235.145.223,443,923,2116643,1976,437,30371,486,2086272,19.741266,60.056636,4045,277907
108.162.221.69,59200,167.235.145.223,443,148,6333206,1587,47,5692,101,6327514,13.185176,54.784335,831,923988
108.162.221.72,22376,167.235.145.223,443,303,4596146,3481,150,12084,153,4584062,73.589349,0.200253,482749,183130819
108.162.221.78,59890,167.235.145.223,443,392,7480289,2938,190,15764,202,7464525,47.14474,33.031906,3817,1807833
108.162.221.98,36102,167.235.145.223,443,6,427,830,2,132,4,295,2.054529,29.939059,35,78
108.162.221.102,33088,167.235.145.223,443,1932,9963447,2232,932,66418,1000,9897029,24.090045,38.155995,13925,2075066
108.162.221.103,11642,167.235.145.223,443,208,1942835,3650,104,8344,104,1934491,82.838637,0.143032,466692,108199060
108.162.221.104,62890,167.235.145.223,443,92,1191718,854,35,3048,57,1188670,2.224459,60.016452,406,158445
108.162.221.105,11928,167.235.145.223,443,182,2171536,3204,89,8141,93,2163395,59.810578,2.230636,29197,7758845
108.162.221.110,42562,167.235.145.223,443,6,427,559,2,132,4,295,1.048378,29.969978,35,78
108.162.221.113,48390,167.235.145.223,443,6,427,2017,2,132,4,295,20.238557,29.785065,35,79
108.162.221.119,9306,167.235.145.223,443,202,2727314,2960,98,8735,104,2718579,47.70228,32.339206,2160,672515
108.162.221.126,25550,167.235.145.223,443,6,427,1303,2,132,4,295,8.130281,29.856191,35,79
108.162.221.127,39338,167.235.145.223,443,78,2460899,1148,36,4001,42,2456898,5.960936,62.035979,515,316835
108.162.221.131,41632,167.235.145.223,443,424,9175145,2988,204,17181,220,9157964,49.566573,18.210971,7547,4023053
108.162.221.131,63250,167.235.145.223,443,6,427,1918,2,132,4,295,18.987908,29.963562,35,78
108.162.221.131,63254,167.235.145.223,443,6,427,1922,2,132,4,295,19.107091,29.91139,35,78
108.162.221.133,40608,167.235.145.223,443,772,2921649,2576,370,26696,402,2894953,29.853941,32.351911,6601,715865
108.162.221.135,13104,167.235.145.223,443,663,4870634,210,393,122505,270,4748129,0.34987,82.247165,11915,461840
108.162.221.135,33732,167.235.145.223,443,351,217966,209,234,109503,117,108463,0.344889,81.965023,10687,10586
108.162.221.136,10776,167.235.145.223,443,400,2243043,187,252,110889,148,2132154,0.302583,81.189604,10926,210091
108.162.221.136,47092,167.235.145.223,443,351,216906,277,234,108444,117,108462,0.450955,82.328027,10537,10539
108.162.221.140,64442,167.235.145.223,443,513,3543261,2618,241,18090,272,3525171,31.482734,30.396014,4761,927798
108.162.221.141,22850,167.235.145.223,443,34,1248054,441,10,1315,24,1246739,0.780217,60.016449,175,166186
108.162.221.143,20918,167.235.145.223,443,170,1361604,1195,82,6718,88,1354886,6.740911,60.059582,894,180472
108.162.221.148,59726,167.235.145.223,443,311,4644860,3232,153,12282,158,4632578,61.522123,0.26793,366722,138322039
108.162.221.150,31514,167.235.145.223,443,1417,4910748,1269,652,45216,765,4865532,7.746251,60.563266,5972,642704
108.162.221.155,41880,167.235.145.223,443,1657,13828076,3032,683,50953,974,13777123,52.392822,27.92616,14596,3946728
108.162.221.165,29458,167.235.145.223,443,351,218828,105,234,110754,117,108074,0.169145,81.530728,10867,10604
108.162.221.165,58270,167.235.145.223,443,351,219126,131,234,111046,117,108080,0.208701,81.666499,10877,10587
108.162.221.166,42546,167.235.145.223,443,385,1488018,149,250,110927,135,1377091,0.241682,81.202055,10928,135670
108.162.221.166,47712,167.235.145.223,443,348,215394,429,229,108581,119,106813,0.75351,80.781494,10753,10577
108.162.221.166,59462,167.235.145.223,443,348,218433,351,232,110827,116,107606,0.59069,80.998142,10946,10627
108.162.221.170,25350,167.235.145.223,443,405,7892419,3414,196,16160,209,7876259,71.148677,3.14382,41121,20042518
108.162.226.143,59066,167.235.145.223,443,612,778801,3276,277,20951,335,757850,65.01948,18.019541,9301,336456
108.162.227.14,32380,167.235.145.223,443,961,975072,2143,397,29710,564,945362,22.864935,60.238503,3945,125549
108.162.227.20,47002,167.235.145.223,443,53,28455,2093,29,12815,24,15640,21.723442,61.045709,1679,2049
108.162.241.7,40052,167.235.145.223,443,6,427,2198,2,132,4,295,23.340904,29.285528,36,80
108.162.241.28,57572,167.235.145.223,443,6,427,2050,2,132,4,295,20.702438,29.280266,36,80
108.162.241.53,28902,167.235.145.223,443,7,493,1350,3,198,4,295,8.868088,29.201909,54,80
108.162.241.82,35686,167.235.145.223,443,618,2250137,3031,282,20097,336,2230040,52.383828,1.140384,140984,15644133
108.162.241.92,48068,167.235.145.223,443,652,2213188,3587,313,22141,339,2191047,79.627524,1.143655,154878,15326629
108.162.241.99,44198,167.235.145.223,443,62,111421,3640,20,2805,42,108616,82.475471,0.572212,39216,1518542
108.162.241.101,39188,167.235.145.223,443,734,2637466,2990,338,23791,396,2613675,49.609869,31.245054,6091,669206
108.162.241.107,40448,167.235.145.223,443,714,4358236,2327,309,22709,405,4335527,25.583384,48.14476,3773,720415
108.162.241.110,21620,167.235.145.223,443,6,427,923,2,132,4,295,2.875376,29.180102,36,80
108.162.241.120,26584,167.235.145.223,443,6,427,1704,2,132,4,295,14.847819,29.192078,36,80
108.162.241.123,21480,167.235.145.223,443,682,2513541,1625,317,22405,365,2491136,13.591718,60.415016,2966,329869
108.162.241.124,20288,167.235.145.223,443,656,2807103,2474,290,20625,366,2786478,28.320689,31.181214,5291,714911
108.162.241.131,30470,167.235.145.223,443,700,2285716,1259,323,22801,377,2262915,7.648699,60.452501,3017,299463
108.162.241.140,44672,167.235.145.223,443,42,26237,1000,28,13258,14,12979,4.109031,78.310098,1354,1325
108.162.241.164,50350,167.235.145.223,443,644,2414575,3399,294,20889,350,2393686,70.443247,1.172179,142565,16336658
108.162.241.186,46890,167.235.145.223,443,702,2523855,2624,318,22471,384,2501384,31.593286,31.229393,5756,640776
108.162.241.216,21636,167.235.145.223,443,153,2416193,2553,78,5980,75,2410213,29.36013,26.463213,1807,728622
108.162.241.221,29994,167.235.145.223,443,711,2361760,1007,330,23265,381,2338495,4.270156,60.45422,3078,309456
108.162.241.224,27214,167.235.145.223,443,591,2157972,1760,263,18843,328,2139129,16.28691,60.407028,2495,283295
108.162.241.230,32730,167.235.145.223,443,702,3854185,2111,324,23703,378,3830482,22.30474,42.303204,4482,724386
108.162.241.239,35632,167.235.145.223,443,643,2333148,3523,271,19371,372,2313777,76.461,1.214445,127603,15241707
108.162.241.241,24050,167.235.145.223,443,648,2475084,3359,294,20887,354,2454197,67.654186,1.092869,152896,17965168
108.162.242.28,10542,167.235.145.223,443,684,2194214,3235,323,22801,361,2171413,61.616255,1.255762,145256,13833277
108.162.242.32,20194,167.235.145.223,443,600,2450864,1405,262,18777,338,2432087,10.270178,60.411068,2486,322071
108.162.242.40,59158,167.235.145.223,443,115,2055126,718,46,3868,69,2051258,1.562581,60.115269,514,272976
108.162.242.50,53492,167.235.145.223,443,6,427,1107,2,132,4,295,5.32865,29.280335,36,80
108.162.242.51,11012,167.235.145.223,443,637,2112762,3165,306,21681,331,2091081,58.407948,1.098246,157931,15232150
108.162.242.57,38764,167.235.145.223,443,643,2396461,1956,289,20557,354,2375904,19.573376,60.403833,2722,314669
108.162.242.63,12888,167.235.145.223,443,6,427,1836,2,132,4,295,17.35075,29.272531,36,80
108.162.242.69,36224,167.235.145.223,443,663,2415829,2907,306,21681,357,2394148,46.361531,31.356306,5531,610823
108.162.242.75,65494,167.235.145.223,443,608,2354931,3267,267,19107,341,2335824,64.427262,1.102604,138631,16947691
108.162.242.89,22848,167.235.145.223,443,6,427,2419,2,132,4,295,26.878801,28.773448,36,82
108.162.242.93,63418,167.235.145.223,443,803,2717336,3484,376,26299,427,2691037,73.631852,1.365624,154062,15764438
108.162.242.95,53248,167.235.145.223,443,620,2153836,2742,292,20755,328,2133081,37.612684,31.142756,5331,547949
108.162.242.103,60166,167.235.145.223,443,7,493,1485,3,198,4,295,11.318423,29.300429,54,80
108.162.242.106,62028,167.235.145.223,443,42,26198,678,28,13230,14,12968,1.430816,78.170875,1353,1327
108.162.242.112,38032,167.235.145.223,443,708,2156639,2785,342,24057,366,2132582,40.377637,31.249012,6158,545958
125.124.215.155,58228,167.235.145.223,22,26,4644,2668,12,2050,14,2594,34.261654,5.335093,3073,3889
140.248.69.21,10742,167.235.145.223,443,244,2661634,1997,120,10548,124,2651086,19.942711,36.090313,2338,587655
140.248.69.21,38854,167.235.145.223,443,3,255,1996,2,201,1,54,19.942578,0.000105,,
140.248.69.25,47314,167.235.145.223,443,193,1227711,2878,92,7607,101,1220104,43.915308,0.221362,274916,44094433
140.248.69.26,26360,167.235.145.223,443,3,255,3241,2,201,1,54,61.786931,7.20E-05,,
140.248.69.26,58344,167.235.145.223,443,168,1096165,3242,81,6881,87,1089284,61.787088,0.200752,274208,43408145
140.248.69.27,21482,167.235.145.223,443,2,120,2900,1,66,1,54,45.499147,2.20E-05,,
140.248.69.29,16630,167.235.145.223,443,3,255,1279,2,201,1,54,7.854507,4.30E-05,,
140.248.69.29,62550,167.235.145.223,443,174,1247651,1280,81,6881,93,1240770,7.854601,60.085789,916,165199
140.248.69.33,33048,167.235.145.223,443,205,1310064,3366,99,8069,106,1301995,68.004551,0.229783,280925,45329550
140.248.69.33,57782,167.235.145.223,443,3,255,3365,2,201,1,54,68.004375,8.10E-05,,
140.248.69.36,17108,167.235.145.223,443,3,255,813,2,201,1,54,1.960888,3.30E-05,,
140.248.69.36,44406,167.235.145.223,443,192,1206589,814,96,7871,96,1198718,1.961069,60.089489,1047,159591
140.248.69.38,26464,167.235.145.223,443,198,1240142,3595,96,7871,102,1232271,79.94913,0.227291,277036,43372452
140.248.69.38,48092,167.235.145.223,443,3,255,3594,2,201,1,54,79.949025,9.40E-05,,
140.248.69.39,13984,167.235.145.223,443,2,120,3448,1,66,1,54,71.850836,1.00E-05,,
140.248.69.41,23438,167.235.145.223,443,193,1375724,3001,96,7871,97,1367853,50.14664,0.201137,313060,54404828
140.248.69.42,2492,167.235.145.223,443,53,1331369,1654,28,2941,25,1328428,13.934527,60.026342,391,177046
140.248.69.43,11952,167.235.145.223,443,42,30416,707,28,16926,14,13490,1.52336,78.07748,1734,1382
140.248.69.45,49338,167.235.145.223,443,2,120,2377,1,66,1,54,26.035649,9.00E-06,,
140.248.69.50,3620,167.235.145.223,443,2,120,3197,1,66,1,54,59.508133,1.30E-05,,
140.248.69.52,17246,167.235.145.223,443,245,2622389,2753,118,10416,127,2611973,37.959098,36.50365,2282,572429
140.248.69.52,51430,167.235.145.223,443,3,255,2752,2,201,1,54,37.959015,4.00E-05,,
140.248.69.59,19192,167.235.145.223,443,250,2686163,2330,122,10680,128,2675483,25.610109,6.398948,13352,3344903
140.248.74.20,15490,167.235.145.223,443,3,255,2246,2,201,1,54,24.319557,1.80E-05,,
140.248.74.20,55078,167.235.145.223,443,20,9662,2247,12,3448,8,6214,24.319807,19.28043,1430,2578
140.248.74.28,20890,167.235.145.223,443,222,1284712,2790,182,14283,40,1270429,40.683218,0.058577,1950663,173505505
140.248.74.31,15508,167.235.145.223,443,318,1416437,737,257,61667,61,1354770,1.618141,81.309782,6067,133294
140.248.74.32,24884,167.235.145.223,443,1196,7348520,2806,1061,81602,135,7266918,41.116866,21.82801,29907,2663336
140.248.74.37,4044,167.235.145.223,443,172,1175507,1785,132,10703,40,1164804,16.656121,60.028167,1426,155234
140.248.74.37,33448,167.235.145.223,443,3,255,1784,2,201,1,54,16.655978,9.80E-05,,
140.248.74.46,24150,167.235.145.223,443,2,120,3561,1,66,1,54,77.713996,1.20E-05,,
140.248.74.47,52128,167.235.145.223,443,2,120,2825,1,66,1,54,41.524746,1.40E-05,,
140.248.74.51,17746,167.235.145.223,443,3,255,1770,2,201,1,54,16.476184,8.70E-05,,
140.248.74.51,45410,167.235.145.223,443,1183,7619556,1771,1041,80214,142,7539342,16.476303,17.871779,35906,3374859
140.248.74.52,46398,167.235.145.223,443,248,1371314,1434,202,15851,46,1355463,10.789616,60.034579,2112,180624
140.248.74.64,6570,167.235.145.223,443,2,120,2908,1,66,1,54,46.420756,3.10E-05,,
140.248.74.66,53734,167.235.145.223,443,1212,8051816,1398,1085,83180,127,7968636,10.040694,14.227547,46771,4480680
140.248.74.68,8822,167.235.145.223,443,990,7824207,3317,840,66921,150,7757286,65.661837,14.636545,36577,4239954
140.248.74.68,18202,167.235.145.223,443,3,255,3316,2,201,1,54,65.661594,9.60E-05,,
140.248.74.70,62974,167.235.145.223,443,849,5337293,66,763,57938,86,5279355,0.107602,68.764555,6740,614194
140.248.74.75,33822,167.235.145.223,443,2,120,3562,1,66,1,54,77.726301,7.00E-06,,
140.248.74.82,27802,167.235.145.223,443,197,1515468,2496,150,11995,47,1503473,28.674156,0.057758,1661414,208244468
140.248.74.84,47068,167.235.145.223,443,174,1229945,3038,134,10859,40,1219086,52.601611,0.055729,1558829,175002027
140.248.74.87,43492,167.235.145.223,443,3,255,3065,2,201,1,54,53.27912,1.50E-05,,
140.248.74.87,45344,167.235.145.223,443,631,5589688,3066,524,41554,107,5548134,53.279217,8.671375,38336,5118573
140.248.74.89,6368,167.235.145.223,443,2,120,3142,1,66,1,54,57.262613,1.50E-05,,
140.248.74.97,18670,167.235.145.223,443,2,120,3325,1,66,1,54,65.996141,8.00E-06,,
140.248.74.103,35514,167.235.145.223,443,2,120,3100,1,66,1,54,55.023973,7.00E-06,,
140.248.74.105,37198,167.235.145.223,443,160,1204852,3170,120,9899,40,1194953,58.776259,0.05731,1381818,166805513
140.248.74.117,42752,167.235.145.223,443,627,4974287,1152,521,42542,106,4931745,6.03001,76.81277,4430,513638
140.248.74.117,49944,167.235.145.223,443,212,1262855,3651,171,13485,41,1249370,82.842949,0.056019,1925775,178420892
140.248.74.123,9106,167.235.145.223,443,951,7299762,3453,808,63268,143,7236494,72.180617,9.115089,55528,6351221
140.248.74.125,32018,167.235.145.223,443,573,4796556,796,491,39907,82,4756649,1.885438,70.17717,4549,542244
140.248.74.127,38062,167.235.145.223,443,2,120,3525,1,66,1,54,76.536091,2.80E-05,,
140.248.74.132,51646,167.235.145.223,443,191,1318732,3271,150,12003,41,1306729,64.621951,0.054477,1762652,191894414
140.248.75.21,58798,167.235.145.223,443,272,7206984,2494,136,16072,136,7190912,28.637581,20.046749,6413,2869657
140.248.75.22,12582,167.235.145.223,443,2,120,3485,1,66,1,54,73.632855,9.00E-06,,
140.248.75.29,39840,167.235.145.223,443,3,255,2120,2,201,1,54,22.560789,7.30E-05,,
140.248.75.29,61130,167.235.145.223,443,289,7393617,2121,146,17457,143,7376160,22.560886,19.990477,6986,2951869
140.248.75.31,54802,167.235.145.223,443,2,120,2106,1,66,1,54,22.092281,2.00E-05,,
140.248.75.52,3198,167.235.145.223,443,73,996281,2673,38,4091,35,992190,34.565715,0.056865,575538,139585333
140.248.75.53,7038,167.235.145.223,443,2,120,1864,1,66,1,54,17.862706,1.90E-05,,
140.248.75.61,47010,167.235.145.223,443,2,120,3337,1,66,1,54,66.709547,1.20E-05,,
140.248.75.63,14672,167.235.145.223,443,2,120,2912,1,66,1,54,46.595288,2.10E-05,,
140.248.75.65,65330,167.235.145.223,443,73,1141142,3656,36,3815,37,1137327,82.998665,0.05442,560823,167192502
140.248.75.69,23940,167.235.145.223,443,2,120,2599,1,66,1,54,30.823623,1.10E-05,,
140.248.75.70,36122,167.235.145.223,443,2,120,985,1,66,1,54,3.841718,1.80E-05,,
140.248.75.71,16386,167.235.145.223,443,2,120,2240,1,66,1,54,24.205824,1.20E-05,,
140.248.75.73,57568,167.235.145.223,443,2,120,988,1,66,1,54,3.90564,3.80E-05,,
140.248.75.74,37058,167.235.145.223,443,162,3683167,3540,81,10240,81,3672927,77.102337,4.36695,18759,6728589
140.248.75.80,31056,167.235.145.223,443,82,1244635,2133,42,4355,40,1240280,22.741404,60.028417,580,165292
140.248.75.82,31650,167.235.145.223,443,42,31104,1016,28,17566,14,13538,4.471387,77.987227,1801,1388
140.248.75.87,3872,167.235.145.223,443,2,120,1212,1,66,1,54,7.060506,1.90E-05,,
140.248.75.92,39630,167.235.145.223,443,277,6957344,2684,144,16664,133,6940680,34.838682,19.798378,6733,2804544
140.248.75.93,36458,167.235.145.223,443,221,5420251,3196,116,13707,105,5406544,59.502192,16.44481,6668,2630152
140.248.75.98,46492,167.235.145.223,443,2,120,2653,1,66,1,54,33.590936,1.80E-05,,
140.248.75.103,5838,167.235.145.223,443,2,120,2067,1,66,1,54,21.020266,1.40E-05,,
140.248.75.104,23330,167.235.145.223,443,265,6815607,2913,132,17013,133,6798594,46.596026,25.947856,5245,2096078
140.248.75.110,40226,167.235.145.223,443,121,2602168,3405,61,6718,60,2595450,70.730823,11.859764,4531,1750759
140.248.75.110,62886,167.235.145.223,443,3,255,3404,2,201,1,54,70.730728,1.90E-05,,
140.248.75.116,48870,167.235.145.223,443,78,1283613,3529,39,4157,39,1279456,76.596487,0.055737,596659,183641889
140.248.75.116,57896,167.235.145.223,443,3,255,3528,2,201,1,54,76.596294,3.60E-05,,
140.248.83.24,40954,167.235.145.223,443,229,2536833,518,109,9822,120,2527011,0.957726,69.154791,1136,292330
140.248.83.24,58228,167.235.145.223,443,3,255,517,2,201,1,54,0.957622,6.90E-05,,
140.248.83.25,32246,167.235.145.223,443,3,255,3079,2,201,1,54,53.768302,1.00E-05,,
140.248.83.25,55236,167.235.145.223,443,196,1403132,3080,92,7607,104,1395525,53.768395,0.233699,260403,47771706
140.248.83.26,39676,167.235.145.223,443,204,1246522,2325,101,8169,103,1238353,25.570015,0.225171,290232,43996891
140.248.83.27,10562,167.235.145.223,443,198,1173690,2671,98,8003,100,1165687,34.366203,0.233004,274776,40022900
140.248.83.28,55342,167.235.145.223,443,155,1225203,2827,64,5759,91,1219444,41.604096,0.209434,219983,46580555
140.248.83.42,2470,167.235.145.223,443,63,45632,485,42,25389,21,20243,0.866169,82.115106,2473,1972
140.248.83.45,21316,167.235.145.223,443,9,5303,3659,5,606,4,4697,83.056104,0.049006,98926,766763
140.248.83.45,35436,167.235.145.223,443,3,255,3658,2,201,1,54,83.055889,7.20E-05,,
140.248.83.47,54876,167.235.145.223,443,180,1374866,2991,85,7145,95,1367721,49.619117,0.194756,293495,56181930
140.248.83.48,22092,167.235.145.223,443,194,1309338,3323,97,7937,97,1301401,65.945008,0.200051,317399,52042769
140.248.83.48,58060,167.235.145.223,443,3,255,3322,2,201,1,54,65.945008,1.40E-05,,
140.248.83.51,13460,167.235.145.223,443,3,255,1064,2,201,1,54,5.031438,2.80E-05,,
140.248.83.51,53516,167.235.145.223,443,189,1248641,1065,95,7805,94,1240836,5.031534,60.090254,1039,165196
140.248.83.57,51378,167.235.145.223,443,183,1097155,3169,87,7277,96,1089878,58.718157,0.22741,255995,38340547
140.248.83.63,32756,167.235.145.223,443,211,1464489,3408,104,8399,107,1456090,70.888207,0.228088,294588,51071165
140.248.83.66,40712,167.235.145.223,443,183,1453617,2557,87,7277,96,1446340,29.427674,0.195037,298486,59325768
140.248.83.69,45138,167.235.145.223,443,193,1273107,1822,89,7409,104,1265698,17.210639,60.097721,986,168485
140.248.83.72,26684,167.235.145.223,443,198,1240142,3569,95,7805,103,1232337,78.127128,0.233574,267324,42208019
140.248.83.72,44520,167.235.145.223,443,3,255,3568,2,201,1,54,78.127035,1.80E-05,,
141.101.76.7,13870,167.235.145.223,443,200,2083954,3167,99,8053,101,2075901,58.698025,0.113876,565738,145835891
141.101.76.11,46816,167.235.145.223,443,132,2353032,636,75,22295,57,2330737,1.26727,78.102266,2283,238736
141.101.76.11,64926,167.235.145.223,443,66,40875,659,44,20494,22,20381,1.357443,79.70745,2056,2045
141.101.76.12,47820,167.235.145.223,443,51,31558,703,34,15814,17,15744,1.518943,78.09934,1619,1612
141.101.76.27,12528,167.235.145.223,443,149,1312150,3512,73,6302,76,1305848,75.830745,0.103525,486993,100910736
141.101.76.42,51400,167.235.145.223,443,209,2316570,3642,101,8185,108,2308385,82.528618,0.117474,557399,157201423
141.101.76.48,61598,167.235.145.223,443,37,1188158,696,14,1732,23,1186426,1.490008,60.012842,230,158156
141.101.76.52,36946,167.235.145.223,443,72,1459899,1459,41,9978,31,1449921,11.001787,72.040982,1108,161010
141.101.76.53,20880,167.235.145.223,443,27,16555,1058,18,8218,9,8337,5.00305,72.032967,912,925
141.101.76.62,26160,167.235.145.223,443,128,1090832,3199,60,5473,68,1085359,59.629356,0.106422,411418,81589069
141.101.76.62,40120,167.235.145.223,443,6,427,811,2,132,4,295,1.949825,29.549051,35,79
141.101.76.75,41666,167.235.145.223,443,147,1360264,1874,69,6038,78,1354226,18.116884,60.053138,804,180403
141.101.76.78,47558,167.235.145.223,443,228,2387153,2910,111,8845,117,2378308,46.54137,30.28791,2336,628186
141.101.76.81,28996,167.235.145.223,443,129,82275,913,86,42447,43,39828,2.784972,78.155914,4344,4076
141.101.76.84,63148,167.235.145.223,443,82,2764118,872,35,3178,47,2760940,2.347657,56.255357,451,392629
141.101.76.86,50134,167.235.145.223,443,138,1199954,3452,67,5906,71,1194048,72.121111,0.106271,444599,89887024
141.101.76.89,30414,167.235.145.223,443,147,1266925,1941,70,6158,77,1260767,19.378149,60.048996,820,167965
141.101.76.97,26768,167.235.145.223,443,135,1244934,2289,61,5510,74,1239424,24.994097,30.36301,1451,326561
141.101.76.100,17092,167.235.145.223,443,144,1305804,3593,69,6038,75,1299766,79.879464,0.102784,469956,101164850
141.101.76.106,59146,167.235.145.223,443,275,4721050,1766,124,10520,151,4710530,16.431977,63.822957,1318,590449
141.101.76.110,19594,167.235.145.223,443,130,997512,2904,63,5642,67,991870,45.895437,30.178922,1495,262930
141.101.76.114,45756,167.235.145.223,443,138,1284354,877,62,5576,76,1278778,2.428567,60.046206,742,170372
141.101.76.125,45182,167.235.145.223,443,140,1326656,1304,62,5576,78,1321080,8.136951,60.049863,742,175997
141.101.76.126,13470,167.235.145.223,443,6,427,2021,2,132,4,295,20.268918,29.974347,35,78
141.101.76.128,60654,167.235.145.223,443,148,1239830,2315,73,6356,75,1233474,25.377067,30.151527,1686,327273
141.101.76.130,14870,167.235.145.223,443,6,427,1787,2,132,4,295,16.703355,29.535872,35,79
141.101.76.137,42328,167.235.145.223,443,6,427,2135,2,132,4,295,22.751912,29.866863,35,79
141.101.76.142,64338,167.235.145.223,443,194,2131804,1773,89,7393,105,2124411,16.488583,60.048517,984,283025
141.101.76.146,58666,167.235.145.223,443,148,1507952,2508,66,5840,82,1502112,28.863205,30.142723,1549,398666
141.101.76.151,15180,167.235.145.223,443,7,493,2502,3,198,4,295,28.732994,29.80176,53,79
141.101.76.155,11182,167.235.145.223,443,133,1395521,3072,56,5209,77,1390312,53.627505,0.107416,387949,103545989
141.101.76.163,39224,167.235.145.223,443,141,1302626,3313,65,5803,76,1296823,65.627486,0.101653,456690,102058807
141.101.76.165,16258,167.235.145.223,443,200,4093765,578,113,24792,87,4068973,1.089779,79.201695,2504,410998
141.101.76.165,64198,167.235.145.223,443,66,40005,786,44,19625,22,20380,1.842507,78.02157,2012,2089
141.101.76.170,55206,167.235.145.223,443,152,1369645,2955,72,6265,80,1363380,47.623672,30.377775,1649,359046
141.101.76.176,40288,167.235.145.223,443,263,4876801,3282,114,9786,149,4867015,65.148656,3.119005,25100,12483506
141.101.76.178,64760,167.235.145.223,443,304,4951978,1420,146,11972,158,4940006,10.616912,63.657983,1504,620818
141.101.76.181,25884,167.235.145.223,443,201,2304010,3526,94,7723,107,2296287,76.543506,0.12238,504853,150108645
141.101.76.183,10770,167.235.145.223,443,51,31720,938,34,15822,17,15898,3.158114,74.551732,1697,1705
141.101.76.185,47112,167.235.145.223,443,242,4586183,2171,98,8730,144,4577453,23.125278,33.180761,2104,1103640
141.101.76.199,64546,167.235.145.223,443,298,6695818,1240,140,12914,158,6682904,7.436082,60.967778,1694,876909
141.101.76.201,28516,167.235.145.223,443,6,427,2388,2,132,4,295,26.259846,29.98182,35,78
141.101.76.202,26204,167.235.145.223,443,274,4491896,1076,127,10644,147,4481252,5.112876,63.217016,1346,567094
141.101.76.206,13922,167.235.145.223,443,191,2068192,2022,87,7132,104,2061060,20.282457,60.047562,950,274590
141.101.76.210,27784,167.235.145.223,443,288,5191863,2941,132,10974,156,5180889,47.169418,33.138943,2649,1250707
141.101.76.213,24524,167.235.145.223,443,246,4421974,1602,118,10719,128,4411255,13.424384,51.442595,1666,686008
141.101.76.214,58456,167.235.145.223,443,7,493,1316,3,198,4,295,8.315998,29.945695,52,78
141.101.76.216,43660,167.235.145.223,443,6,427,2514,2,132,4,295,28.925974,29.836826,35,79
141.101.76.224,20848,167.235.145.223,443,196,2122881,2786,91,7525,105,2115356,40.507087,30.279029,1988,558896
141.101.76.231,23910,167.235.145.223,443,6,427,1629,2,132,4,295,13.654813,29.827974,35,79
141.101.76.232,34854,167.235.145.223,443,114,71655,62,76,36458,38,35197,0.095422,78.026928,3737,3608
141.101.76.234,34102,167.235.145.223,443,42,26969,634,28,14000,14,12969,1.263527,78.012542,1435,1329
141.101.76.236,41244,167.235.145.223,443,105,1197611,950,64,23376,41,1174235,3.331119,78.022237,2396,120400
141.101.76.238,48650,167.235.145.223,443,292,5342759,3416,129,10776,163,5331983,71.15967,3.13816,27470,13592635
141.101.76.244,16704,167.235.145.223,443,141,4590931,1850,68,8249,73,4582682,17.634009,60.00998,1099,610922
141.101.76.247,54468,167.235.145.223,443,64,2051729,860,27,2583,37,2049146,2.263229,60.014831,344,273151
141.101.76.249,60976,167.235.145.223,443,6,427,1273,2,132,4,295,7.785111,29.935758,35,78
141.101.76.254,39250,167.235.145.223,443,158,1448419,2615,77,6620,81,1441799,31.382139,30.186466,1754,382104
141.101.77.6,38506,167.235.145.223,443,80,2315013,1018,38,3376,42,2311637,4.504904,60.015032,450,308141
141.101.77.11,38564,167.235.145.223,443,6,427,1427,2,132,4,295,10.747395,29.853467,35,79
141.101.77.14,24722,167.235.145.223,443,6,427,1693,2,132,4,295,14.613897,29.629535,35,79
141.101.77.15,39620,167.235.145.223,443,140,1224179,3341,67,5906,73,1218273,67.053114,0.102772,459736,94833067
141.101.77.20,49798,167.235.145.223,443,42,26126,844,28,13148,14,12978,2.183095,80.509007,1306,1289
141.101.77.20,62648,167.235.145.223,443,42,25862,771,28,12892,14,12970,1.759598,78.462957,1314,1322
141.101.77.22,46912,167.235.145.223,443,187,1390512,808,100,19109,87,1371403,1.938664,78.074234,1958,140522
141.101.77.24,19326,167.235.145.223,443,82,2346415,1415,41,3574,41,2342841,10.522844,60.017036,476,312290
141.101.77.26,26076,167.235.145.223,443,271,4310839,3182,135,11172,136,4299667,59.11612,3.311068,26993,10388592
141.101.77.27,62900,167.235.145.223,443,223,3593648,2828,111,9707,112,3583941,41.623412,28.991618,2678,988959
141.101.77.30,20162,167.235.145.223,443,159,1276656,3024,77,6566,82,1270090,52.068775,30.403336,1727,334197
141.101.77.34,62602,167.235.145.223,443,155,4954951,2375,75,6561,80,4948390,26.029353,36.351063,1443,1089022
141.101.77.39,61042,167.235.145.223,443,6,427,1983,2,132,4,295,19.806519,29.696715,35,79
141.101.77.45,29572,167.235.145.223,443,132,83621,931,88,42850,44,40771,3.061269,79.361138,4319,4109
141.101.77.47,32550,167.235.145.223,443,7,493,2157,3,198,4,295,22.990399,29.768512,53,79
141.101.77.52,13164,167.235.145.223,443,253,4351822,3541,114,9786,139,4342036,77.121286,3.254924,24052,10671919
141.101.77.58,41244,167.235.145.223,443,6,427,866,2,132,4,295,2.288292,29.956193,35,78
141.101.77.63,47018,167.235.145.223,443,311,5012701,2358,159,13180,152,4999521,25.858901,30.517026,3455,1310618
141.101.77.66,14120,167.235.145.223,443,6,427,1271,2,132,4,295,7.778414,29.732909,35,79
141.101.96.11,61530,167.235.145.223,443,205,2385523,3383,86,7084,119,2378439,68.750105,0.190748,297104,99752091
141.101.96.17,60196,167.235.145.223,443,6,427,914,2,132,4,295,2.79542,29.668019,35,79
141.101.96.37,10390,167.235.145.223,443,6,427,1709,2,132,4,295,14.926465,29.873383,35,79
141.101.96.40,38268,167.235.145.223,443,42,25163,898,28,12180,14,12983,2.615183,78.055111,1248,1330
141.101.96.50,28656,167.235.145.223,443,218,2386382,2894,86,7084,132,2379298,44.738009,30.467794,1860,624737
141.101.96.85,60746,167.235.145.223,443,216,2223527,3011,91,7414,125,2216113,50.745119,30.383376,1952,583506
141.101.96.87,36962,167.235.145.223,443,237,2330368,3256,111,8734,126,2321634,63.288006,0.188576,370524,98491175
141.101.96.94,64402,167.235.145.223,443,215,2316855,3611,93,7546,122,2309309,80.758495,0.196729,306858,93908229
141.101.96.106,43062,167.235.145.223,443,237,2426828,1345,105,8338,132,2418490,8.790639,60.072039,1110,322078
141.101.96.110,22364,167.235.145.223,443,241,2779636,2417,111,8734,130,2770902,26.733655,30.268646,2308,732349
141.101.96.127,35820,167.235.145.223,443,193,2122572,2771,81,6754,112,2115818,38.747796,30.425775,1775,556322
141.101.96.142,63544,167.235.145.223,443,231,2330003,908,106,8404,125,2321599,2.714939,60.072651,1119,309172
141.101.96.152,56012,167.235.145.223,443,6,427,2435,2,132,4,295,27.204514,29.569687,35,79
141.101.96.163,26780,167.235.145.223,443,217,2133211,1699,97,7810,120,2125401,14.714386,60.068968,1040,283061
141.101.96.174,60854,167.235.145.223,443,185,2082853,3136,85,7018,100,2075835,56.736181,0.134151,418513,123790951
141.101.96.177,56186,167.235.145.223,443,199,2068739,2051,92,7480,107,2061259,20.734054,60.049537,996,274607
141.101.96.220,16844,167.235.145.223,443,216,2304889,3504,97,7810,119,2297079,74.733638,0.164094,380757,111988445
141.101.96.233,21114,167.235.145.223,443,6,427,856,2,132,4,295,2.241354,29.809923,35,79
141.101.96.240,12298,167.235.145.223,443,7,493,2059,3,198,4,295,20.90016,29.88741,52,78
141.101.96.242,20782,167.235.145.223,443,6,427,1006,2,132,4,295,4.235586,29.911566,35,78
141.101.96.252,39652,167.235.145.223,443,6,427,1362,2,132,4,295,9.010384,29.757115,35,79
141.101.96.253,23824,167.235.145.223,443,199,1770394,2646,91,7414,108,1762980,32.836122,30.188784,1964,467188
141.101.98.91,52912,167.235.145.223,443,335,4724772,1899,153,12196,182,4712576,18.649101,61.007317,1599,617968
141.101.98.95,33026,167.235.145.223,443,7,493,1590,3,198,4,295,13.199654,29.957773,52,78
141.101.98.103,31014,167.235.145.223,443,6,427,556,2,132,4,295,1.040655,29.966421,35,78
141.101.98.106,22980,167.235.145.223,443,42,26170,895,28,13202,14,12968,2.613275,78.044715,1353,1329
141.101.98.133,16506,167.235.145.223,443,372,4956228,1558,181,14044,191,4942184,12.616276,60.958104,1843,648600
141.101.98.151,34208,167.235.145.223,443,328,4495296,1184,149,11932,179,4483364,6.60684,60.875697,1568,589182
141.101.98.158,37944,167.235.145.223,443,42,23538,756,28,10570,14,12968,1.70344,78.153496,1081,1327
141.101.98.188,59408,167.235.145.223,443,6,427,2312,2,132,4,295,25.328457,29.995622,35,78
141.101.98.214,48516,167.235.145.223,443,42,26857,645,28,13888,14,12969,1.30123,78.097992,1422,1328
141.101.98.217,31538,167.235.145.223,443,327,4242063,2715,157,12460,170,4229603,36.651058,31.333415,3181,1079895
141.101.98.229,41232,167.235.145.223,443,42,26324,328,28,13356,14,12968,0.550763,78.096708,1368,1328
141.101.98.234,62362,167.235.145.223,443,317,4590968,2265,139,11272,178,4579696,24.629538,31.216585,2888,1173657
141.101.99.14,44766,167.235.145.223,443,302,4354891,3575,130,10678,172,4344213,78.680734,1.89296,45127,18359449
141.101.99.18,32690,167.235.145.223,443,323,4838427,3094,140,11338,183,4827089,54.657437,1.534376,59114,25167698
141.101.99.30,31478,167.235.145.223,443,7,493,1218,3,198,4,295,7.135496,29.993744,52,78
141.101.99.109,49374,167.235.145.223,443,352,5195924,2970,163,12856,189,5183068,48.67047,31.472024,3267,1317504
141.101.99.118,65170,167.235.145.223,443,377,4076625,2843,169,13252,208,4063373,42.652519,31.469258,3368,1032975
141.101.99.138,58290,167.235.145.223,443,42,24490,619,28,11522,14,12968,1.234057,78.107298,1180,1328
141.101.99.142,24144,167.235.145.223,443,371,5963650,3459,158,12966,213,5950684,72.674435,1.841383,56331,25853107
141.101.99.147,58284,167.235.145.223,443,327,4314371,3217,156,12394,171,4301977,60.654961,1.651685,60030,20836791
141.101.99.150,11852,167.235.145.223,443,339,4881653,3334,154,12262,185,4869391,66.663519,1.720346,57021,22643775
141.101.99.185,39396,167.235.145.223,443,352,4972925,2595,165,12988,187,4959937,30.697089,31.190856,3331,1272151
141.101.99.192,14820,167.235.145.223,443,42,23034,638,28,10066,14,12968,1.278856,79.185618,1016,1310
141.101.99.196,33762,167.235.145.223,443,320,4121080,362,152,12130,168,4108950,0.619022,60.788716,1596,540751
141.101.99.210,60954,167.235.145.223,443,6,427,1932,2,132,4,295,19.267824,29.967099,35,78
141.101.104.71,46328,167.235.145.223,443,142,1239414,2219,66,5874,76,1233540,23.693707,30.498677,1540,323565
141.101.104.73,46726,167.235.145.223,443,127,1090771,3202,60,5478,67,1085293,59.729628,0.10308,425145,84229181
141.101.104.74,26510,167.235.145.223,443,141,4056077,1514,73,6429,68,4049648,11.813006,59.905022,858,540809
141.101.104.84,22142,167.235.145.223,443,295,5342958,3417,132,10974,163,5331984,71.172647,0.5797,151443,73582666
141.101.104.87,52928,167.235.145.223,443,153,1448069,2570,71,6204,82,1441865,29.709606,30.219902,1642,381699
141.101.104.90,10252,167.235.145.223,443,135,1166644,2706,63,5676,72,1160968,35.703853,30.110536,1508,308454
141.101.104.104,63642,167.235.145.223,443,72,3304236,233,16,2667,56,3301569,0.383036,77.338662,275,341518
141.101.104.106,41238,167.235.145.223,443,6,427,2586,2,132,4,295,30.192754,29.566355,35,79
141.101.104.114,16556,167.235.145.223,443,90,57468,637,60,29679,30,27789,1.27096,81.831272,2901,2716
141.101.105.2,53074,167.235.145.223,443,312,6126055,3060,141,12435,171,6113620,53.168189,12.563371,7918,3892980
141.101.105.6,51726,167.235.145.223,443,236,4350700,3547,99,8796,137,4341904,77.195706,0.624035,112762,55662313
141.101.105.19,44168,167.235.145.223,443,6,427,1142,2,132,4,295,5.775297,29.945516,35,78
141.101.105.27,33136,167.235.145.223,443,6,427,1515,2,132,4,295,11.858701,29.964302,35,78
141.101.105.37,36490,167.235.145.223,443,6,427,2221,2,132,4,295,23.702635,29.971296,35,78
141.101.105.40,61144,167.235.145.223,443,278,4877792,3280,128,10710,150,4867082,65.143021,0.508854,168378,76518325
141.101.105.45,16420,167.235.145.223,443,120,1231946,3560,52,4950,68,1226996,77.712358,0.106864,370564,91854768
141.101.105.47,25678,167.235.145.223,443,152,1457027,3443,73,6336,79,1450691,71.727023,0.107467,471661,107991550
141.101.105.53,15678,167.235.145.223,443,6,427,1167,2,132,4,295,6.200551,29.533222,35,79
141.101.105.55,49514,167.235.145.223,443,261,4491039,1082,117,9984,144,4481055,5.137059,60.691865,1316,590663
141.101.105.57,27066,167.235.145.223,443,151,1369584,2959,73,6336,78,1363248,47.698177,30.370611,1668,359096
141.101.105.62,17116,167.235.145.223,443,102,2175766,644,54,16588,48,2159178,1.300484,78.199831,1696,220888
141.101.105.62,45054,167.235.145.223,443,108,2176241,810,60,17370,48,2158871,1.948062,78.128593,1778,221058
141.101.105.64,23520,167.235.145.223,443,126,77833,395,84,38925,42,38908,0.688357,78.21572,3981,3979
141.101.105.64,25328,167.235.145.223,443,129,78192,245,86,38313,43,39879,0.397977,79.634823,3848,4006
141.101.105.70,43418,167.235.145.223,443,137,1395790,3077,61,5544,76,1390246,53.702923,0.105687,419654,105234967
141.101.105.71,27566,167.235.145.223,443,144,1242585,1139,66,5874,78,1236711,5.699746,60.055224,782,164743
141.101.105.79,37820,167.235.145.223,443,6,427,113,2,132,4,295,0.182641,29.538394,35,79
141.101.105.83,41404,167.235.145.223,443,262,4587503,2168,118,10050,144,4577453,23.11106,30.701749,2618,1192753
141.101.105.85,49558,167.235.145.223,443,301,4951706,1471,145,11832,156,4939874,11.11468,60.475214,1565,653474
141.101.105.89,63518,167.235.145.223,443,155,1339741,1510,75,6468,80,1333273,11.716287,60.046625,861,177631
141.101.105.98,54494,167.235.145.223,443,290,5191995,2936,131,10908,159,5181087,47.138881,30.629229,2849,1353239
141.101.105.104,58666,167.235.145.223,443,6,427,1865,2,132,4,295,17.867034,29.884089,35,78
141.101.105.124,53546,167.235.145.223,443,252,4237277,2692,116,9918,136,4227359,35.125624,30.464132,2604,1110120
141.101.105.130,22680,167.235.145.223,443,135,1220875,2830,63,5676,72,1215199,41.701261,30.105595,1508,322916
141.101.105.137,10794,167.235.145.223,443,42,26786,942,28,13818,14,12968,3.236231,78.044458,1416,1329
141.101.105.138,17914,167.235.145.223,443,42,26114,292,28,13146,14,12968,0.475577,78.066154,1347,1328
141.101.105.155,46626,167.235.145.223,443,398,9673785,1811,173,15291,225,9658494,17.101498,42.952856,2847,1798901
141.101.105.159,25048,167.235.145.223,443,6,427,2237,2,132,4,295,24.177883,29.567907,35,79
157.52.78.20,51584,167.235.145.223,443,334,1523982,2410,160,12127,174,1511855,26.581782,0.390274,248584,30990637
157.52.78.22,50004,167.235.145.223,443,96,2526001,1080,53,5588,43,2520413,5.126318,73.988413,604,272519
157.52.78.24,16394,167.235.145.223,443,390,9161243,464,219,48918,171,9112325,0.821199,82.132134,4764,887577
157.52.78.25,5908,167.235.145.223,443,493,13901952,1320,264,28758,229,13873194,8.339552,74.766138,3077,1484436
157.52.78.26,40364,167.235.145.223,443,444,12742258,695,238,26414,206,12715844,1.488364,63.704569,3317,1596851
157.52.78.27,46336,167.235.145.223,443,138,3882334,1731,74,9112,64,3873222,15.656559,36.416388,2001,850874
157.52.78.28,29150,167.235.145.223,443,371,3822483,2858,189,16083,182,3806400,43.316812,33.44556,3846,910470
157.52.78.29,3100,167.235.145.223,443,825,12739637,2257,446,42157,379,12697480,24.496215,56.512755,5967,1797467
157.52.78.30,33492,167.235.145.223,443,88,2543665,2770,47,5336,41,2538329,38.746492,35.243258,1211,576184
157.52.78.31,28550,167.235.145.223,443,611,9415626,3088,318,29049,293,9386577,54.100533,27.499215,8450,2730718
157.52.78.32,31496,167.235.145.223,443,911,24968123,698,513,56059,398,24912064,1.496862,75.671441,5926,2633708
157.52.78.33,54756,167.235.145.223,443,423,9381361,500,239,61146,184,9320215,0.914153,82.152016,5954,907606
157.52.78.34,20160,167.235.145.223,443,317,8937570,1862,174,18687,143,8918883,17.845649,51.119802,2924,1395761
157.52.106.20,16122,167.235.145.223,443,273,2551636,2709,127,10946,146,2540690,36.061293,3.412454,25661,5956276
157.52.106.21,6274,167.235.145.223,443,478,9135227,3255,226,23169,252,9112058,63.03137,18.04507,10271,4039688
157.52.106.22,25302,167.235.145.223,443,853,25501377,160,445,53448,408,25447929,0.261545,75.071937,5695,2711844
157.52.106.23,62440,167.235.145.223,443,261,7665670,350,136,16611,125,7649059,0.587093,82.25565,1615,743930
157.52.106.24,43792,167.235.145.223,443,361,10859421,1541,187,22131,174,10837290,12.261527,70.306175,2518,1233153
157.52.106.25,56708,167.235.145.223,443,433,7293618,2819,216,21288,217,7272330,41.285278,15.783112,10790,3686132
157.52.106.26,14844,167.235.145.223,443,3,255,2480,2,201,1,54,28.483798,3.90E-05,,
157.52.106.26,21106,167.235.145.223,443,597,12477983,2481,293,29457,304,12448526,28.483989,29.017808,8121,3431968
157.52.106.27,22730,167.235.145.223,443,570,12020338,3098,278,28675,292,11991663,54.915409,26.131251,8778,3671209
157.52.106.27,33326,167.235.145.223,443,3,255,3097,2,201,1,54,54.915182,8.70E-05,,
157.52.106.29,37964,167.235.145.223,443,102,2561929,1185,56,12136,46,2549793,6.620042,69.222542,1402,294677
157.52.106.30,10146,167.235.145.223,443,400,6821594,2958,190,18575,210,6803019,47.664735,12.956252,11469,4200609
157.52.106.30,34076,167.235.145.223,443,3,255,2957,2,201,1,54,47.664734,2.80E-05,,
157.52.106.31,28910,167.235.145.223,443,977,28861215,700,508,60533,469,28800682,1.508816,58.5719,8267,3933720
157.52.106.32,19238,167.235.145.223,443,143,1310254,110,89,43089,54,1267165,0.175271,82.168515,4195,123372
157.52.106.33,37704,167.235.145.223,443,340,10361027,1466,176,20456,164,10340571,11.052856,41.656483,3928,1985874
157.52.106.34,5856,167.235.145.223,443,273,8137791,139,143,17121,130,8120670,0.227019,33.234707,4121,1954744
157.52.106.35,36930,167.235.145.223,443,28,17261,115,18,9644,10,7617,0.185313,80.706512,955,755
157.52.106.35,47738,167.235.145.223,443,2,120,1636,1,66,1,54,13.710618,1.50E-05,,
157.52.106.35,52612,167.235.145.223,443,385,3069638,2056,203,41005,182,3028633,20.871929,61.892007,5300,391473
157.52.106.37,23730,167.235.145.223,443,381,5812628,3438,182,16954,199,5795674,71.667057,8.952721,15149,5178916
157.52.106.37,24412,167.235.145.223,443,3,255,3437,2,201,1,54,71.666809,2.60E-05,,
157.52.106.38,32848,167.235.145.223,443,7,2205,2058,4,1357,3,848,20.897699,60.031248,180,113
157.52.108.30,8788,167.235.145.223,443,17,7810,3275,9,2177,8,5633,64.97782,0.047393,367480,950857
162.158.18.6,12792,167.235.145.223,443,426,4887501,3285,205,15734,221,4871767,65.171279,2.581217,48764,15099131
162.158.18.32,35032,167.235.145.223,443,416,4844696,3052,205,15759,211,4828937,53.05533,2.721646,46321,14194166
162.158.18.42,31880,167.235.145.223,443,333,2433266,1325,155,11739,178,2421527,8.395112,60.131208,1561,322165
162.158.18.64,52936,167.235.145.223,443,6,427,986,2,132,4,295,3.85266,29.77222,35,79
162.158.18.74,45710,167.235.145.223,443,277,1242199,3585,135,10319,142,1231880,79.574398,0.332128,248554,29672415
162.158.18.77,35890,167.235.145.223,443,7,493,1815,3,198,4,295,17.150826,29.770103,53,79
162.158.18.79,35102,167.235.145.223,443,336,2483036,1250,159,12744,177,2470292,7.538837,62.160774,1640,317922
162.158.18.84,40830,167.235.145.223,443,6,427,774,2,132,4,295,1.7833,29.944433,35,78
162.158.18.87,59606,167.235.145.223,443,474,5354713,3429,240,18044,234,5336669,71.370601,2.38225,60594,17921440
162.158.18.91,51134,167.235.145.223,443,349,2337861,3269,170,12729,179,2325132,64.543232,0.368202,276565,50518617
162.158.18.93,26928,167.235.145.223,443,346,2477473,2324,163,12832,183,2464641,25.547237,41.885003,2450,470744
162.158.18.103,27808,167.235.145.223,443,83,1332659,330,38,3173,45,1329486,0.55665,60.03852,422,177151
162.158.18.113,52288,167.235.145.223,443,6,427,2287,2,132,4,295,24.973553,29.876633,35,78
162.158.18.114,56820,167.235.145.223,443,293,2437821,2868,142,11446,151,2426375,43.550967,9.430464,9709,2058329
162.158.18.124,33316,167.235.145.223,443,330,2603161,3357,158,12678,172,2590483,67.648334,5.504401,18425,3764962
162.158.18.131,44642,167.235.145.223,443,403,5047246,1620,196,16044,207,5031202,13.544393,60.079594,2136,669938
162.158.18.138,23292,167.235.145.223,443,291,177798,451,194,87863,97,89935,0.795145,82.142087,8557,8758
162.158.18.138,39686,167.235.145.223,443,291,177951,454,194,87937,97,90014,0.802637,80.854088,8700,8906
162.158.18.138,44998,167.235.145.223,443,291,176518,373,194,86659,97,89859,0.649075,81.436151,8513,8827
162.158.18.139,43874,167.235.145.223,443,294,179389,352,196,88538,98,90851,0.591504,82.507642,8584,8808
162.158.18.153,53760,167.235.145.223,443,313,1778017,2685,155,11737,158,1766280,34.895647,30.34354,3094,465675
162.158.18.162,27342,167.235.145.223,443,389,4159031,3007,186,14626,203,4144405,50.378319,32.595508,3589,1017172
162.158.18.165,38326,167.235.145.223,443,291,1405845,3116,144,10913,147,1394932,55.549068,0.329939,264606,33822785
162.158.18.178,12282,167.235.145.223,443,188,114724,382,126,57598,62,57126,0.659492,80.052357,5756,5708
162.158.18.178,62942,167.235.145.223,443,189,115424,369,126,56989,63,58435,0.636944,79.697614,5720,5865
162.158.18.179,48670,167.235.145.223,443,189,115703,452,126,57342,63,58361,0.799933,80.864331,5672,5773
162.158.18.179,48684,167.235.145.223,443,186,113591,597,124,56162,62,57429,1.137675,79.39081,5659,5786
162.158.18.179,52852,167.235.145.223,443,186,113351,546,124,55919,62,57432,1.013905,79.280896,5642,5795
162.158.18.183,51808,167.235.145.223,443,324,2140374,1719,156,11805,168,2128569,15.363103,60.134335,1570,283175
162.158.18.186,61760,167.235.145.223,443,334,2077750,2112,163,12267,171,2065483,22.375251,60.148431,1631,274718
162.158.18.188,56896,167.235.145.223,443,448,5202390,2926,217,16551,231,5185839,47.05922,32.764813,4041,1266197
162.158.18.192,47246,167.235.145.223,443,361,2400346,710,176,13866,185,2386480,1.532814,62.135426,1785,307261
162.158.18.195,28728,167.235.145.223,443,6,427,2353,2,132,4,295,25.836289,29.976307,35,78
162.158.18.200,45462,167.235.145.223,443,6,427,2169,2,132,4,295,23.122169,29.788328,35,79
162.158.18.205,10004,167.235.145.223,443,428,4598427,2163,213,16287,215,4582140,23.050646,32.732771,3980,1119890
162.158.18.210,44272,167.235.145.223,443,6,427,788,2,132,4,295,1.846695,29.818751,35,79
162.158.18.210,44284,167.235.145.223,443,6,427,829,2,132,4,295,2.053667,29.81562,35,79
162.158.19.52,65080,167.235.145.223,443,311,2891183,2621,147,11937,164,2879246,31.554056,41.499365,2301,555043
162.158.19.55,43364,167.235.145.223,443,427,4977840,2476,206,15659,221,4962181,28.351219,33.430388,3747,1187465
162.158.19.64,22752,167.235.145.223,443,6,427,1438,2,132,4,295,10.876388,29.709398,35,79
162.158.19.67,27038,167.235.145.223,443,6,427,2197,2,132,4,295,23.33623,29.962144,35,78
162.158.19.67,38008,167.235.145.223,443,348,2395061,3409,170,12727,178,2382334,70.991359,0.409501,248634,46541209
162.158.19.77,16490,167.235.145.223,443,273,170161,80,182,85712,91,84449,0.124339,81.790055,8383,8260
162.158.19.77,27048,167.235.145.223,443,273,169836,79,182,85536,91,84300,0.123539,81.933708,8351,8231
162.158.19.78,34598,167.235.145.223,443,270,167779,181,180,84409,90,83370,0.29749,82.799908,8155,8055
162.158.19.78,52822,167.235.145.223,443,273,170225,198,182,85854,91,84371,0.316822,82.313477,8344,8199
162.158.19.79,9822,167.235.145.223,443,287,1378451,2987,141,10715,146,1367736,49.546031,30.376326,2821,360211
162.158.19.86,55872,167.235.145.223,443,380,2788909,2509,188,13915,192,2774994,28.884438,30.377367,3664,730805
162.158.19.89,51480,167.235.145.223,443,397,4361316,3535,189,14726,208,4346590,76.9141,2.841637,41457,12236862
162.158.19.95,49204,167.235.145.223,443,383,4245724,2670,186,14339,197,4231385,34.278864,33.677284,3406,1005160
162.158.19.107,14006,167.235.145.223,443,12,5927,3657,6,1047,6,4880,83.022322,0.07359,113819,530506
162.158.19.107,44800,167.235.145.223,443,150,4367043,679,76,6622,74,4360421,1.432353,60.338931,877,578123
162.158.19.120,10644,167.235.145.223,443,347,2313634,3538,168,12595,179,2301039,77.021962,0.398273,252992,46220336
162.158.19.122,52038,167.235.145.223,443,489,6811068,1070,243,19851,246,6791217,5.057071,68.071806,2332,798123
162.158.19.123,57918,167.235.145.223,443,361,2133761,2716,184,13653,177,2120108,36.68274,30.395871,3593,557998
162.158.19.133,15462,167.235.145.223,443,6,427,1879,2,132,4,295,18.176034,29.744586,35,79
162.158.19.140,40976,167.235.145.223,443,6,427,1277,2,132,4,295,7.848279,29.934123,35,78
162.158.19.141,50244,167.235.145.223,443,385,4077284,2798,190,14769,195,4062515,41.055771,32.736086,3609,992791
162.158.19.143,17590,167.235.145.223,443,216,128315,417,144,61614,72,66701,0.718047,80.91168,6091,6594
162.158.19.143,27680,167.235.145.223,443,216,128026,377,144,61325,72,66701,0.655176,80.5983,6086,6620
162.158.19.143,29984,167.235.145.223,443,219,131478,191,146,63777,73,67701,0.310319,82.315023,6198,6579
162.158.19.144,42156,167.235.145.223,443,216,125650,244,144,59258,72,66392,0.396501,81.812032,5794,6492
162.158.19.146,52332,167.235.145.223,443,502,7468886,1399,245,20009,257,7448877,10.04661,71.76073,2230,830412
162.158.19.149,29140,167.235.145.223,443,424,4320904,3178,216,16485,208,4304419,59.062732,2.688654,49050,12807654
162.158.19.154,18012,167.235.145.223,443,337,2092986,3145,160,12069,177,2080917,57.406524,0.388929,248250,42803020
162.158.19.157,64406,167.235.145.223,443,6,427,1891,2,132,4,295,18.373076,29.908714,35,78
162.158.19.164,31728,167.235.145.223,443,342,2911290,3480,161,12876,181,2898414,73.56808,8.814103,11686,2630705
162.158.19.170,13168,167.235.145.223,443,6,427,1984,2,132,4,295,19.814511,29.955559,35,78
162.158.19.171,63728,167.235.145.223,443,406,4729600,1744,185,14450,221,4715150,15.891794,63.871331,1809,590581
162.158.19.173,37648,167.235.145.223,443,293,2178845,3233,145,11820,148,2167025,61.551587,11.399075,8295,1520842
162.158.22.7,29592,167.235.145.223,443,258,2681374,3491,115,9081,143,2672293,73.923009,0.214728,338325,99560113
162.158.22.32,32926,167.235.145.223,443,263,2494888,2630,123,9609,140,2485279,31.85233,30.342935,2533,655250
162.158.22.46,30202,167.235.145.223,443,247,2605332,2997,104,8355,143,2596977,49.859734,30.354258,2201,684444
162.158.22.106,21150,167.235.145.223,443,233,2164456,3244,105,8421,128,2156035,61.857109,0.25121,268174,68660801
162.158.22.113,40700,167.235.145.223,443,306,4560308,2750,139,11505,167,4548803,37.855019,30.078925,3059,1209831
162.158.22.116,22720,167.235.145.223,443,254,2304472,2356,120,9411,134,2295061,25.845456,30.216537,2491,607630
162.158.22.138,60846,167.235.145.223,443,228,2067728,783,104,8355,124,2059373,1.835443,60.083678,1112,274200
162.158.22.142,50708,167.235.145.223,443,6,427,2013,2,132,4,295,20.182644,29.677428,35,79
162.158.22.146,55642,167.235.145.223,443,250,2256024,1272,115,9081,135,2246943,7.784283,60.08224,1209,299182
162.158.22.161,60148,167.235.145.223,443,42,26310,758,28,13342,14,12968,1.710932,78.07803,1367,1328
162.158.22.164,23270,167.235.145.223,443,256,2370927,1982,117,9213,139,2361714,19.788576,60.08451,1226,314452
162.158.22.167,57798,167.235.145.223,443,233,2185542,3592,106,8487,127,2177055,79.872206,0.216063,314241,80608155
162.158.22.179,37676,167.235.145.223,443,6,427,1663,2,132,4,295,14.006157,29.858756,35,79
162.158.22.196,24430,167.235.145.223,443,6,427,2373,2,132,4,295,26.00693,29.868915,35,79
162.158.22.221,57704,167.235.145.223,443,251,2427805,3128,111,8817,140,2418988,55.853151,0.270685,260583,71492339
162.158.23.32,52606,167.235.145.223,443,6,427,1299,2,132,4,295,8.041261,29.770535,35,79
162.158.23.46,38264,167.235.145.223,443,225,2043405,2876,101,8157,124,2035248,43.892625,30.515694,2138,533560
162.158.23.53,49358,167.235.145.223,443,6,427,843,2,132,4,295,2.158775,29.68796,35,79
162.158.23.59,58490,167.235.145.223,443,272,2486490,1644,127,9873,145,2476617,13.791502,60.086176,1314,329742
162.158.33.132,28228,167.235.145.223,443,369,2501793,2640,165,12289,204,2489504,32.429526,30.458898,3227,653865
162.158.33.133,23894,167.235.145.223,443,362,2501332,2633,169,12554,193,2488778,32.051761,30.444794,3298,653977
162.158.33.135,35548,167.235.145.223,443,8,3710,2080,5,1790,3,1920,21.370636,46.569754,307,329
162.158.33.135,60368,167.235.145.223,443,10,3841,1231,6,1856,4,1985,7.317287,66.210361,224,239
162.158.33.157,39876,167.235.145.223,443,335,4495808,1298,151,12114,184,4483694,8.028572,60.387353,1604,593991
162.158.33.161,18076,167.235.145.223,443,342,4954298,1662,155,12378,187,4941920,14.00203,60.393455,1639,654629
162.158.60.131,65384,167.235.145.223,443,319,2311752,3501,151,11439,168,2300313,74.524696,0.338517,270332,54362126
162.158.60.133,37330,167.235.145.223,443,356,2395555,2888,179,13287,177,2382268,44.545369,30.35218,3502,627900
162.158.60.139,49838,167.235.145.223,443,145,4384797,885,74,6528,71,4378269,2.516417,54.046684,966,648072
162.158.60.140,62036,167.235.145.223,443,361,2395885,3377,187,13815,174,2382070,68.521008,0.386853,285689,49260468
162.158.60.143,22574,167.235.145.223,443,327,2131481,2765,159,11967,168,2119514,38.573483,30.432353,3145,557173
162.158.60.144,52996,167.235.145.223,443,204,6285525,1336,103,9264,101,6276261,8.559433,54.396969,1362,923030
162.158.60.147,19402,167.235.145.223,443,120,4368078,2035,51,5010,69,4363068,20.522908,42.037836,953,830312
162.158.60.148,30992,167.235.145.223,443,92,2326963,879,42,14836,50,2312127,2.448713,78.115451,1519,236790
162.158.60.150,36166,167.235.145.223,443,158,4973288,1355,77,6726,81,4966562,8.905926,72.172291,745,550522
162.158.62.14,45782,167.235.145.223,443,7,493,1692,3,198,4,295,14.587629,29.408298,53,80
162.158.62.52,26052,167.235.145.223,443,651,2520496,2626,322,22743,329,2497753,31.642614,30.91833,5884,646284
162.158.62.55,19246,167.235.145.223,443,7,493,1338,3,198,4,295,8.615904,29.366244,53,80
162.158.62.59,44328,167.235.145.223,443,618,2280311,1257,296,21027,322,2259284,7.6375,60.336982,2787,299555
162.158.62.106,58024,167.235.145.223,443,42,26310,711,28,13342,14,12968,1.533499,78.097509,1366,1328
162.158.62.151,59806,167.235.145.223,443,568,2090168,743,264,18915,304,2071253,1.639384,60.347195,2507,274578
162.158.62.159,57214,167.235.145.223,443,592,2326780,2334,276,19707,316,2307073,25.642052,30.957882,5092,596183
162.158.62.171,45814,167.235.145.223,443,608,2210292,3588,297,21093,311,2189199,79.656521,0.917412,183934,19090214
162.158.62.172,12866,167.235.145.223,443,605,2628960,2993,278,19839,327,2609121,49.653927,30.916939,5133,675130
162.158.62.178,49794,167.235.145.223,443,636,2396006,1964,305,21621,331,2374385,19.642077,60.346712,2866,314765
162.158.62.188,23668,167.235.145.223,443,659,2707840,3486,317,22413,342,2685427,73.667576,0.92402,194047,23249946
162.158.62.198,39292,167.235.145.223,443,7,493,2411,3,198,4,295,26.594517,29.404634,53,80
162.158.62.215,13948,167.235.145.223,443,587,2067297,2871,282,20103,305,2047194,43.661269,30.983092,5190,528596
162.158.62.243,26484,167.235.145.223,443,6,427,893,2,132,4,295,2.586977,29.398389,35,80
162.158.63.59,15454,167.235.145.223,443,607,2152987,2744,298,21159,309,2131828,37.653942,30.944166,5470,551141
162.158.63.78,22326,167.235.145.223,443,7,493,2040,3,198,4,295,20.589271,29.399402,53,80
162.158.63.80,23668,167.235.145.223,443,660,2454798,3119,330,23271,330,2431527,55.65664,0.90942,204710,21389694
162.158.63.96,55618,167.235.145.223,443,644,2511042,1627,312,22083,332,2488959,13.650328,60.34114,2927,329985
162.158.63.109,43158,167.235.145.223,443,605,2189009,3238,285,20301,320,2168708,61.649687,0.948548,171217,18290760
162.158.63.115,29266,167.235.145.223,443,641,2474630,3358,311,22017,330,2452613,67.649853,0.916714,192138,21403517
162.158.74.21,55994,167.235.145.223,443,6,427,2400,2,132,4,295,26.406532,29.992814,35,78
162.158.74.24,28158,167.235.145.223,443,363,2435106,3130,164,12224,199,2422882,56.035352,0.438295,223119,44223767
162.158.74.25,55322,167.235.145.223,443,280,2429626,3133,133,10177,147,2419449,56.390658,0.243202,334766,79586483
162.158.74.26,14104,167.235.145.223,443,6,427,2034,2,132,4,295,20.52175,29.696271,35,79
162.158.74.27,15158,167.235.145.223,443,6,427,2043,2,132,4,295,20.62358,29.828861,35,79
162.158.74.35,61720,167.235.145.223,443,45,26716,809,30,12821,15,13895,1.944658,78.058549,1313,1424
162.158.74.36,41698,167.235.145.223,443,257,2129795,2760,118,9187,139,2120608,38.440465,30.280085,2427,560264
162.158.74.37,32720,167.235.145.223,443,296,2132370,2755,111,8726,185,2123644,38.081385,30.47957,2290,557394
162.158.74.47,49860,167.235.145.223,443,384,2457577,3367,182,13412,202,2444165,68.062088,0.449869,238504,43464475
162.158.74.47,49868,167.235.145.223,443,280,2450712,3376,132,10111,148,2440601,68.406478,0.265197,305010,73623789
162.158.74.62,33106,167.235.145.223,443,7,493,876,3,198,4,295,2.422282,29.975251,52,78
162.158.74.73,27640,167.235.145.223,443,341,4725217,2000,154,12312,187,4712905,20.009156,60.399676,1630,624229
162.158.74.108,61478,167.235.145.223,443,6,427,1014,2,132,4,295,4.455734,29.866314,35,79
162.158.74.116,51444,167.235.145.223,443,423,2056382,2880,199,14534,224,2041848,44.045394,30.47461,3815,536012
162.158.74.117,19076,167.235.145.223,443,255,2045293,2887,120,9319,135,2035974,44.402154,30.307244,2459,537422
162.158.86.12,12458,167.235.145.223,443,185,2327082,1017,87,7265,98,2319817,4.498851,60.030836,968,309150
162.158.86.18,26374,167.235.145.223,443,90,57364,601,60,29572,30,27792,1.164103,81.927499,2887,2713
162.158.86.23,60150,167.235.145.223,443,159,2352606,53,95,27512,64,2325094,0.084805,82.490545,2668,225489
162.158.86.27,65270,167.235.145.223,443,87,55247,76,58,28384,29,26863,0.120635,79.562484,2854,2701
162.158.86.40,36914,167.235.145.223,443,158,2471345,1300,75,7257,83,2464088,8.055328,62.595382,927,314922
162.158.86.40,46514,167.235.145.223,443,178,2181939,3567,87,7260,91,2174679,78.117975,0.056957,1019716,305448531
162.158.86.47,63340,167.235.145.223,443,6,427,1763,2,132,4,295,16.364068,29.9595,35,78
162.158.86.62,20080,167.235.145.223,443,115,1231625,3550,56,5223,59,1226402,77.203526,0.051704,808138,189757388
162.158.86.65,47352,167.235.145.223,443,265,5190381,2964,122,10350,143,5180031,48.110182,10.65093,7773,3890763
162.158.86.66,14790,167.235.145.223,443,126,80307,143,84,41398,42,38909,0.231119,79.725782,4154,3904
162.158.86.68,34950,167.235.145.223,443,6,427,1020,2,132,4,295,4.532993,29.960669,35,78
162.158.86.73,35112,167.235.145.223,443,7,493,1050,3,198,4,295,4.951285,29.817302,53,79
162.158.86.77,23352,167.235.145.223,443,129,82448,275,86,42544,43,39904,0.449908,79.283854,4292,4026
162.158.86.80,19394,167.235.145.223,443,213,4234749,2688,92,8379,121,4226370,34.964929,41.6112,1610,812544
162.158.86.94,49510,167.235.145.223,443,259,4876574,3326,123,10416,136,4866158,66.121312,10.299093,8090,3779873
162.158.86.107,9618,167.235.145.223,443,198,2424370,1414,96,7859,102,2416511,10.514275,60.03221,1047,322028
162.158.86.109,14336,167.235.145.223,443,6,427,882,2,132,4,295,2.46285,29.602619,35,79
162.158.86.113,19052,167.235.145.223,443,77,2454816,2125,37,4098,40,2450718,22.623727,33.917211,966,578047
162.158.86.128,27032,167.235.145.223,443,178,2326589,3268,83,7001,95,2319588,64.542517,0.058966,949835,314701760
162.158.86.143,33546,167.235.145.223,443,42,24734,945,28,11760,14,12974,3.268599,78.043046,1205,1329
162.158.86.146,17358,167.235.145.223,443,132,1455716,3493,67,5949,65,1449767,74.022661,0.052932,899115,219113881
162.158.86.155,48506,167.235.145.223,443,73,2118687,1775,36,3248,37,2115439,16.503124,60.010437,432,282009
162.158.86.171,35426,167.235.145.223,443,209,2777639,2484,101,8189,108,2769450,28.508157,30.318796,2160,730754
162.158.86.172,42286,167.235.145.223,443,73,2508843,1783,29,3570,44,2505273,16.635225,63.451264,450,315867
162.158.86.182,18652,167.235.145.223,443,81,2376788,832,38,4164,43,2372624,2.061784,62.785926,530,302312
162.158.86.191,33286,167.235.145.223,443,229,4308104,3212,105,9228,124,4298876,60.203258,10.368105,7120,3317000
162.158.86.203,43710,167.235.145.223,443,130,4103451,94,60,5453,70,4097998,0.153493,70.512076,618,464941
162.158.86.211,15790,167.235.145.223,443,6,427,2204,2,132,4,295,23.476725,29.968843,35,78
162.158.86.221,25654,167.235.145.223,443,69,44045,907,46,22742,23,21303,2.711101,77.83594,2337,2189
162.158.86.222,35708,167.235.145.223,443,42,26718,716,28,13748,14,12970,1.558477,78.048925,1409,1329
162.158.86.226,11536,167.235.145.223,443,15,3899,1202,8,1684,7,2215,6.822738,71.212,189,248
162.158.86.244,9558,167.235.145.223,443,6,427,2119,2,132,4,295,22.553545,29.969966,35,78
162.158.86.250,31690,167.235.145.223,443,48,29380,709,32,14557,16,14823,1.528297,78.033351,1492,1519
162.158.87.4,50916,167.235.145.223,443,6,427,887,2,132,4,295,2.519902,29.975642,35,78
162.158.87.17,29312,167.235.145.223,443,6,427,2495,2,132,4,295,28.64313,29.744691,35,79
162.158.87.19,58364,167.235.145.223,443,154,2465971,815,90,27449,64,2438522,1.977356,80.766107,2718,241539
162.158.87.25,57336,167.235.145.223,443,6,427,2132,2,132,4,295,22.73127,29.784448,35,79
162.158.87.37,34094,167.235.145.223,443,190,2303288,3527,98,7991,92,2295297,76.563431,0.059344,1077244,309422620
162.158.87.50,56068,167.235.145.223,443,20,9602,2436,10,2738,10,6864,27.221338,51.658978,424,1062
162.158.87.60,32966,167.235.145.223,443,166,2220343,3036,77,6605,89,2213738,52.523526,30.19343,1750,586548
162.158.87.64,31020,167.235.145.223,443,49,1330627,717,24,2460,25,1328167,1.559122,60.008368,327,177064
162.158.87.105,22288,167.235.145.223,443,93,58741,13,62,30026,31,28715,0.010447,78.9379,3042,2910
162.158.87.110,52324,167.235.145.223,443,7,493,1788,3,198,4,295,16.703966,29.809571,53,79
162.158.87.119,48064,167.235.145.223,443,116,4476370,1155,41,4353,75,4472017,6.093349,70.453281,494,507799
162.158.87.134,34306,167.235.145.223,443,261,4722885,3451,123,10416,138,4712469,72.118156,10.716014,7776,3518076
162.158.87.145,50866,167.235.145.223,443,6,427,1843,2,132,4,295,17.509884,29.947587,35,78
162.158.87.148,61852,167.235.145.223,443,119,1301173,3419,59,5413,60,1295760,71.188556,0.05173,837115,200388169
162.158.87.156,29568,167.235.145.223,443,6,427,1436,2,132,4,295,10.842475,29.716189,35,79
162.158.87.157,57094,167.235.145.223,443,169,2066874,2116,79,6737,90,2060137,22.508812,60.030018,897,274547
162.158.87.160,15740,167.235.145.223,443,160,2664182,1543,74,7036,86,2657146,12.284421,61.776596,911,344097
162.158.87.171,49892,167.235.145.223,443,87,55044,891,58,28172,29,26872,2.563048,79.914831,2820,2690
162.158.87.173,48588,167.235.145.223,443,68,2401510,1027,26,2496,42,2399014,4.76386,60.009875,332,319815
162.158.87.181,47268,167.235.145.223,443,249,4719276,1794,117,10029,132,4709247,16.769849,42.465291,1889,887171
162.158.87.183,26614,167.235.145.223,443,183,2384187,3400,89,7397,94,2376790,70.553414,0.05921,999425,321133592
162.158.87.185,51450,167.235.145.223,443,256,4587151,2122,125,10557,131,4576594,22.564482,42.44619,1989,862568
162.158.87.190,39098,167.235.145.223,443,144,1766879,2672,67,5945,77,1760934,34.512624,30.382994,1565,463663
162.158.87.198,39886,167.235.145.223,443,301,7074583,2488,129,11693,172,7062890,28.557372,42.115617,2221,1341619
162.158.87.202,51630,167.235.145.223,443,309,7017870,1456,140,12419,169,7005451,10.992862,47.550016,2089,1178624
162.158.87.209,27352,167.235.145.223,443,243,4833397,3078,108,9475,135,4823922,53.761473,10.86758,6974,3551055
162.158.87.212,17194,167.235.145.223,443,170,2881948,2492,81,7653,89,2874295,28.611111,33.530875,1825,685766
162.158.87.219,10420,167.235.145.223,443,216,4066200,2836,93,8436,123,4057764,42.09944,40.534587,1664,800849
162.158.87.232,26910,167.235.145.223,443,192,2384781,2909,96,7859,96,2376922,46.531314,30.420388,2066,625086
162.158.87.235,11634,167.235.145.223,443,153,2320352,2677,75,7257,78,2313095,34.624467,33.46466,1734,552964
162.158.94.7,27766,167.235.145.223,443,6,427,886,2,132,4,295,2.517823,29.766197,35,79
162.158.94.10,47398,167.235.145.223,443,119,1243945,1973,58,5349,61,1238596,19.719036,60.024862,712,165077
162.158.94.12,58726,167.235.145.223,443,124,1325637,763,60,5481,64,1320156,1.714384,60.025188,730,175946
162.158.94.20,16086,167.235.145.223,443,6,427,2559,2,132,4,295,29.455992,29.992942,35,78
162.158.94.28,31300,167.235.145.223,443,342,4885297,137,200,69151,142,4816146,0.223741,79.991041,6915,481668
162.158.94.29,11834,167.235.145.223,443,262,1822799,405,166,66528,96,1756271,0.700908,80.971805,6572,173519
162.158.94.30,39482,167.235.145.223,443,6,427,981,2,132,4,295,3.73936,29.880702,35,78
162.158.94.39,19872,167.235.145.223,443,166,2120921,2756,79,6753,87,2114168,38.184553,30.052834,1797,562786
162.158.94.40,29166,167.235.145.223,443,189,116579,225,126,58133,63,58446,0.36803,80.089408,5806,5838
162.158.94.41,27440,167.235.145.223,443,189,116862,315,126,58494,63,58368,0.525795,80.859162,5787,5774
162.158.94.41,40186,167.235.145.223,443,186,113922,461,124,56338,62,57584,0.808755,79.406869,5675,5801
162.158.94.48,17478,167.235.145.223,443,6,427,1378,2,132,4,295,9.532097,29.975415,35,78
162.158.94.59,14542,167.235.145.223,443,247,4755045,2885,115,9646,132,4745399,44.27657,35.839432,2153,1059257
162.158.94.61,55136,167.235.145.223,443,7,493,2386,3,198,4,295,26.199851,29.545484,53,79
162.158.94.67,40292,167.235.145.223,443,255,161393,430,170,82645,85,78748,0.754129,82.237053,8039,7660
162.158.94.67,51522,167.235.145.223,443,255,160227,185,170,81482,85,78745,0.298783,81.390278,8009,7739
162.158.94.79,30630,167.235.145.223,443,44,1212744,2028,22,2322,22,1210422,20.383214,59.903163,310,161650
162.158.94.81,18848,167.235.145.223,443,162,2778843,3050,75,7126,87,2771717,53.012062,0.745845,76434,29729683
162.158.94.82,41340,167.235.145.223,443,112,1198275,3123,55,5151,57,1193124,55.735739,0.050987,808206,187204424
162.158.94.84,52006,167.235.145.223,443,174,106658,83,116,52930,58,53728,0.125238,81.382056,5203,5281
162.158.94.85,28978,167.235.145.223,443,171,103463,669,114,50662,57,52801,1.395032,80.077027,5061,5275
162.158.94.86,58892,167.235.145.223,443,132,1937860,3634,52,4952,80,1932908,82.32163,0.067804,584272,228058285
162.158.94.94,61338,167.235.145.223,443,202,6336681,2449,101,9167,101,6327514,27.711946,37.888425,1935,1336031
162.158.94.108,13568,167.235.145.223,443,6,427,1682,2,132,4,295,14.317559,29.972208,35,78
162.158.94.118,43320,167.235.145.223,443,213,130172,402,142,64322,71,65850,0.698363,80.559788,6387,6539
162.158.94.118,61698,167.235.145.223,443,216,132166,346,144,65459,72,66707,0.581123,81.359726,6436,6559
162.158.94.119,27728,167.235.145.223,443,213,133181,436,142,67412,71,65769,0.770264,80.75032,6678,6515
162.158.94.140,13628,167.235.145.223,443,186,2314861,3624,96,7664,90,2307197,81.484113,0.058389,1050060,316113925
162.158.94.154,35722,167.235.145.223,443,118,1367409,2872,55,5151,63,1362258,43.718727,30.25167,1362,360246
162.158.94.156,41894,167.235.145.223,443,349,3698527,309,210,81195,139,3617332,0.516784,82.208991,7901,352013
162.158.94.157,14388,167.235.145.223,443,364,1393317,260,225,83947,139,1309370,0.424297,81.812499,8208,128036
162.158.94.164,29656,167.235.145.223,443,110,1168036,1638,52,4953,58,1163083,13.719188,60.025669,660,155011
162.158.94.181,60790,167.235.145.223,443,6,427,838,2,132,4,295,2.109249,29.635188,35,79
162.158.94.193,17732,167.235.145.223,443,156,98441,334,104,50192,52,48249,0.564632,80.842414,4966,4774
162.158.94.193,45578,167.235.145.223,443,156,97596,781,104,49729,52,47867,1.800179,81.050432,4908,4724
162.158.94.199,64160,167.235.145.223,443,308,7243920,3048,137,12360,171,7231560,52.989185,0.718476,137624,80521103
162.158.94.206,52716,167.235.145.223,443,268,6517741,3520,112,10394,156,6507347,76.256505,0.88234,94240,59000811
162.158.94.213,43258,167.235.145.223,443,107,1357661,1267,42,4293,65,1353368,7.73655,60.022792,572,180380
162.158.94.217,40892,167.235.145.223,443,321,8003943,3410,136,12138,185,7991805,71.084423,0.672293,144437,95099071
162.158.94.226,61144,167.235.145.223,443,276,6093741,2793,125,11551,151,6082190,40.981827,30.777491,3002,1580944
162.158.94.228,37174,167.235.145.223,443,339,209547,331,226,104730,113,104817,0.559602,80.718523,10379,10388
162.158.94.229,28254,167.235.145.223,443,342,211606,87,228,105928,114,105678,0.13589,81.241665,10430,10406
162.158.94.241,38624,167.235.145.223,443,119,1506075,2344,52,4953,67,1501122,25.75542,30.251448,1309,396971
162.158.94.247,26092,167.235.145.223,443,111,1309679,3240,51,4887,60,1304792,61.744227,0.047472,823559,219884057
162.158.94.251,37636,167.235.145.223,443,44,1188546,962,20,2054,24,1186492,3.541027,60.008702,273,158175
162.158.95.5,22684,167.235.145.223,443,159,2899193,3433,71,6915,88,2892278,71.489007,0.255098,216857,90703274
162.158.95.13,32364,167.235.145.223,443,270,167521,57,180,84078,90,83443,0.090597,80.47687,8357,8294
162.158.95.13,65188,167.235.145.223,443,267,164390,504,178,81880,89,82510,0.931866,79.278101,8262,8326
162.158.95.17,14314,167.235.145.223,443,153,1767489,2611,75,6489,78,1761000,31.191809,30.151489,1721,467240
162.158.95.22,46400,167.235.145.223,443,322,7047251,3278,150,13009,172,7034242,65.119661,0.603325,172497,93273005
162.158.95.27,44092,167.235.145.223,443,6,427,1736,2,132,4,295,15.756481,29.635069,35,79
162.158.95.29,40774,167.235.145.223,443,189,116345,450,126,57911,63,58434,0.793385,79.832251,5803,5855
162.158.95.30,39768,167.235.145.223,443,189,116764,590,126,58333,63,58431,1.123324,80.12764,5824,5833
162.158.95.33,54758,167.235.145.223,443,199,2776995,2296,91,7545,108,2769450,25.125186,30.05684,2008,737123
162.158.95.38,18506,167.235.145.223,443,304,6873015,2138,141,12576,163,6860439,22.787897,30.670864,3280,1789434
162.158.95.48,30590,167.235.145.223,443,210,130848,276,140,66166,70,64682,0.450455,81.247672,6514,6368
162.158.95.48,38642,167.235.145.223,443,269,2183295,602,169,68816,100,2114479,1.166373,80.013292,6880,211412
162.158.95.49,64342,167.235.145.223,443,139,2451934,3555,63,6387,76,2445547,77.472922,0.238324,214397,82091505
162.158.95.56,28732,167.235.145.223,443,155,2477146,3308,77,7311,78,2469835,65.505729,0.216929,269618,91083626
162.158.95.63,16182,167.235.145.223,443,212,1191156,539,136,58985,76,1132171,1.002926,81.128987,5816,111641
162.158.95.63,20110,167.235.145.223,443,276,1195965,93,168,61685,108,1134280,0.152734,80.683175,6116,112467
162.158.95.64,16766,167.235.145.223,443,180,114373,571,120,58952,60,55421,1.077704,81.059932,5818,5469
162.158.95.76,33148,167.235.145.223,443,6,427,1675,2,132,4,295,14.194197,29.553338,35,79
162.158.95.85,47170,167.235.145.223,443,322,7416268,1409,143,12345,179,7403923,10.354887,60.521678,1631,978680
162.158.95.93,16376,167.235.145.223,443,93,58726,676,62,30008,31,28718,1.421729,78.250073,3067,2936
162.158.95.94,53888,167.235.145.223,443,93,59069,24,62,30347,31,28722,0.03105,79.543113,3052,2888
162.158.95.98,12026,167.235.145.223,443,119,1304191,3361,59,5415,60,1298776,67.725557,0.047471,912557,218874849
162.158.95.107,28914,167.235.145.223,443,6,427,1288,2,132,4,295,7.914277,29.821142,35,79
162.158.95.110,38566,167.235.145.223,443,222,4774558,2199,109,11073,113,4763485,23.351905,41.767259,2120,912386
162.158.95.115,22230,167.235.145.223,443,291,180170,772,194,90261,97,89909,1.760958,81.23992,8888,8853
162.158.95.115,59806,167.235.145.223,443,292,180629,4,195,90758,97,89871,0.002262,83.022809,8745,8659
162.158.95.118,15302,167.235.145.223,443,182,2131023,1681,92,7602,90,2123421,14.270432,60.026318,1013,282998
162.158.95.126,18558,167.235.145.223,443,84,2871006,791,36,3901,48,2867105,1.865201,58.177163,536,394258
162.158.95.130,12216,167.235.145.223,443,158,2220815,2972,68,6039,90,2214776,48.779577,30.419264,1588,582466
162.158.95.134,46048,167.235.145.223,443,166,2325812,3246,71,6225,95,2319587,62.185789,0.073624,676409,252046832
162.158.95.135,9984,167.235.145.223,443,174,2520593,1804,89,8128,85,2512465,17.003566,60.735978,1070,330935
162.158.95.140,27998,167.235.145.223,443,172,2665076,1460,86,7930,86,2657146,11.006615,60.711874,1044,350131
162.158.95.143,62160,167.235.145.223,443,171,2725176,2918,86,7852,85,2717324,46.99198,30.79659,2039,705876
162.158.95.156,9180,167.235.145.223,443,348,7939350,2921,154,13797,194,7925553,47.006615,30.708633,3594,2064710
162.158.95.163,29356,167.235.145.223,443,160,2429145,2795,81,7522,79,2421623,41.005214,30.731697,1958,630390
162.158.95.168,45718,167.235.145.223,443,110,1282512,3488,52,4953,58,1277559,73.744979,0.050769,780476,201313242
162.158.95.169,25090,167.235.145.223,443,372,233799,416,248,118854,124,114945,0.717916,81.514635,11664,11280
162.158.95.170,42984,167.235.145.223,443,368,232235,437,245,118296,123,113939,0.772328,80.988518,11685,11254
162.158.95.171,35618,167.235.145.223,443,6,427,2026,2,132,4,295,20.311206,29.975207,35,78
162.158.95.176,61674,167.235.145.223,443,192,3323425,3106,86,8085,106,3315340,55.234008,27.622269,2341,960193
162.158.95.178,58238,167.235.145.223,443,6,427,2203,2,132,4,295,23.475071,29.97034,35,78
162.158.95.180,26476,167.235.145.223,443,6,427,1999,2,132,4,295,20.006587,29.742791,35,79
162.158.95.184,43028,167.235.145.223,443,375,9317279,1039,167,15865,208,9301414,4.89676,71.406984,1777,1042073
162.158.95.190,31890,167.235.145.223,443,98,995437,2628,46,4557,52,990880,31.715484,30.174015,1208,262710
162.158.95.191,34574,167.235.145.223,443,195,119022,475,130,58967,65,60055,0.840498,81.472876,5790,5896
162.158.95.192,34758,167.235.145.223,443,192,116777,561,128,57440,64,59337,1.052579,81.057009,5669,5856
162.158.95.195,45948,167.235.145.223,443,347,7074480,1745,167,14011,180,7060469,15.916748,60.411712,1855,934980
162.158.95.199,23408,167.235.145.223,443,283,4757783,3373,145,11988,138,4745795,68.223377,0.084961,1128800,446868092
162.158.95.205,59950,167.235.145.223,443,6,427,2039,2,132,4,295,20.584408,29.992393,35,78
162.158.95.211,25894,167.235.145.223,443,311,6457634,3174,144,12818,167,6444816,58.883158,0.865638,118460,59561303
162.158.95.218,59680,167.235.145.223,443,92,2599285,1310,41,3833,51,2595452,8.243637,60.008829,510,346009
162.158.95.220,50218,167.235.145.223,443,6,427,1323,2,132,4,295,8.390439,29.618196,35,79
162.158.95.223,54810,167.235.145.223,443,6,427,1671,2,132,4,295,14.056548,29.969911,35,78
162.158.95.226,33540,167.235.145.223,443,179,2302569,3498,87,7272,92,2295297,74.289346,0.055398,1050146,331462796
162.158.102.48,30098,167.235.145.223,443,271,2187898,3580,114,8864,157,2179034,79.40369,0.314201,225689,55481274
162.158.102.52,27246,167.235.145.223,443,294,2071933,655,136,10316,158,2061617,1.353254,60.122019,1372,274324
162.158.102.73,12732,167.235.145.223,443,306,2497576,2616,143,10778,163,2486798,31.391695,30.325901,2843,656019
162.158.102.119,27660,167.235.145.223,443,339,2490761,1597,166,12296,173,2478465,13.355879,60.124277,1636,329778
162.158.102.124,17578,167.235.145.223,443,324,2308940,2314,155,11570,169,2297370,25.356166,30.327695,3051,606012
162.158.102.171,59468,167.235.145.223,443,323,2134092,2733,151,11306,172,2122786,37.360593,30.373635,2977,559112
162.158.102.187,35234,167.235.145.223,443,6,427,762,2,132,4,295,1.712905,29.801271,35,79
162.158.102.230,35540,167.235.145.223,443,317,2453095,3350,155,11570,162,2441525,67.398745,0.314756,294069,62055052
162.158.103.5,55586,167.235.145.223,443,303,2373878,1942,141,10646,162,2363232,19.400505,60.118759,1416,314475
162.158.103.7,53458,167.235.145.223,443,6,427,1635,2,132,4,295,13.709729,29.800166,35,79
162.158.103.16,40572,167.235.145.223,443,42,24197,629,28,11228,14,12969,1.257048,78.081376,1150,1328
162.158.103.88,12506,167.235.145.223,443,302,2168860,3228,147,11042,155,2157818,61.360115,0.306955,287781,56238028
162.158.103.125,10624,167.235.145.223,443,316,2260229,1235,153,11438,163,2248791,7.389151,60.120601,1522,299237
162.158.103.128,63852,167.235.145.223,443,290,2047544,2862,129,9854,161,2037690,43.396905,30.406538,2592,536118
162.158.103.196,45940,167.235.145.223,443,359,2612573,2985,174,12824,185,2599749,49.353504,30.464061,3367,682705
162.158.110.5,17646,167.235.145.223,443,240,150466,19,160,76350,80,74116,0.017181,82.351996,7416,7199
162.158.110.5,42708,167.235.145.223,443,240,152344,258,160,78076,80,74268,0.423541,82.235065,7595,7224
162.158.110.7,44992,167.235.145.223,443,237,4832979,1210,100,8896,137,4824083,7.043326,64.365,1105,599590
162.158.110.29,47124,167.235.145.223,443,6,427,1190,2,132,4,295,6.661198,29.936194,35,78
162.158.110.32,65348,167.235.145.223,443,165,2664612,1425,78,7395,87,2657217,10.703268,61.887308,955,343491
162.158.110.34,18880,167.235.145.223,443,147,2476594,2223,68,6784,79,2469810,23.741126,30.890756,1756,639624
162.158.110.50,27716,167.235.145.223,443,41,1188336,348,17,1844,24,1186492,0.585967,60.00789,245,158178
162.158.110.52,48460,167.235.145.223,443,6,427,1488,2,132,4,295,11.363402,29.905959,35,78
162.158.110.55,58612,167.235.145.223,443,305,7306616,3277,131,11603,174,7295013,65.101871,1.037499,89469,56250756
162.158.110.58,42062,167.235.145.223,443,231,4247990,1641,106,9294,125,4238696,13.738206,63.628318,1168,532932
162.158.110.60,10028,167.235.145.223,443,304,7243254,3053,132,11628,172,7231626,53.059603,1.050036,88591,55096213
162.158.110.68,57102,167.235.145.223,443,187,2384467,3344,92,7611,95,2376856,67.128101,0.096207,632885,197645160
162.158.110.80,43416,167.235.145.223,443,153,93980,104,102,46738,51,47242,0.168088,80.119261,4666,4717
162.158.110.81,43266,167.235.145.223,443,150,91971,130,100,45653,50,46318,0.207254,79.593202,4588,4655
162.158.110.84,9138,167.235.145.223,443,318,6873436,2145,152,12798,166,6860638,22.919341,30.775017,3326,1783430
162.158.110.99,18620,167.235.145.223,443,487,5797273,549,297,104384,190,5692889,1.029889,81.616566,10231,558013
162.158.110.99,31616,167.235.145.223,443,360,1689182,550,232,98099,128,1591083,1.030707,82.026421,9567,155177
162.158.110.100,64250,167.235.145.223,443,159,2249681,1124,66,5510,93,2244171,5.46924,60.028234,734,299082
162.158.110.101,47616,167.235.145.223,443,224,4489963,1043,93,8364,131,4481599,4.919268,60.547065,1105,592147
162.158.110.111,14554,167.235.145.223,443,6,427,2195,2,132,4,295,23.315779,29.998668,35,78
162.158.110.111,14570,167.235.145.223,443,8,559,2225,4,264,4,295,23.828616,29.514244,71,79
162.158.110.114,24246,167.235.145.223,443,157,2609837,3257,77,7378,80,2602459,63.28843,4.452758,13255,4675680
162.158.110.123,64956,167.235.145.223,443,134,1981551,2649,67,6718,67,1974833,33.181892,37.169586,1445,425042
162.158.110.125,56050,167.235.145.223,443,152,2470889,1099,71,6932,81,2463957,5.240429,61.310939,904,321503
162.158.110.128,50140,167.235.145.223,443,258,4641506,320,125,10546,133,4630960,0.538849,64.863621,1300,571162
162.158.110.129,35340,167.235.145.223,443,246,4616619,3601,117,10077,129,4606542,80.455668,2.383594,33821,15460827
162.158.110.137,65358,167.235.145.223,443,6,427,1493,2,132,4,295,11.44871,29.953806,35,78
162.158.110.152,34846,167.235.145.223,443,255,155862,376,170,77112,85,78750,0.651059,80.726169,7641,7804
162.158.110.152,64548,167.235.145.223,443,255,155460,102,170,76712,85,78748,0.166484,80.98628,7577,7778
162.158.110.155,29788,167.235.145.223,443,110,1140807,3643,56,5149,54,1135658,82.542991,0.051956,792824,174864577
162.158.110.159,29672,167.235.145.223,443,143,2434159,3015,68,6784,75,2427375,51.203892,7.017915,7733,2767061
162.158.110.169,23848,167.235.145.223,443,354,218389,499,236,109076,118,109313,0.909918,82.16672,10619,10643
162.158.110.169,59344,167.235.145.223,443,350,214304,714,234,106775,116,107529,1.544737,80.114616,10662,10737
162.158.110.179,9912,167.235.145.223,443,238,4592014,3469,109,9534,129,4582480,73.132943,9.051453,8426,4050160
162.158.110.187,46264,167.235.145.223,443,237,150093,625,158,76913,79,73180,1.246469,80.098211,7681,7309
162.158.110.187,49380,167.235.145.223,443,237,149909,777,158,76725,79,73184,1.789849,81.262739,7553,7204
162.158.110.194,52282,167.235.145.223,443,235,4350451,3521,113,9537,122,4340914,76.332947,2.244458,33993,15472471
162.158.110.195,15212,167.235.145.223,443,166,2180978,3522,79,6563,87,2174415,76.356573,0.057404,914640,303033238
162.158.110.196,12916,167.235.145.223,443,294,6456114,3177,141,12222,153,6443892,59.055979,1.106985,88326,46568956
162.158.110.199,59352,167.235.145.223,443,338,8004860,3412,151,12923,187,7991937,71.110472,1.401337,73775,45624639
162.158.110.204,48530,167.235.145.223,443,145,2325860,1937,68,6784,77,2319076,19.291586,61.757929,878,300408
162.158.110.207,13236,167.235.145.223,443,313,7072151,1790,140,12144,173,7060007,16.731349,60.735271,1599,929938
162.158.110.214,50130,167.235.145.223,443,209,3866590,3637,99,8561,110,3858029,82.403921,0.641572,106750,48107199
162.158.110.225,61332,167.235.145.223,443,276,5877400,1255,142,14313,134,5863087,7.634358,52.796177,2168,888410
162.158.110.227,10380,167.235.145.223,443,156,2555600,349,73,7114,83,2548486,0.586859,65.019201,875,313567
162.158.110.229,11714,167.235.145.223,443,6,427,2563,2,132,4,295,29.559062,29.953755,35,78
162.158.110.233,51596,167.235.145.223,443,187,3521914,2605,85,7963,102,3513951,31.086192,34.316701,1856,819181
162.158.110.236,32192,167.235.145.223,443,246,151546,95,164,75591,82,75955,0.154584,80.024304,7556,7593
162.158.110.236,53016,167.235.145.223,443,243,152790,219,162,77761,81,75029,0.358934,79.510754,7823,7549
162.158.110.246,17764,167.235.145.223,443,216,4623495,2182,105,10833,111,4612662,23.206456,38.599753,2245,955998
162.158.110.249,21550,167.235.145.223,443,171,2725309,2954,86,7984,85,2717325,47.606802,32.253202,1980,673998
162.158.110.252,16904,167.235.145.223,443,393,244755,312,262,123638,131,121117,0.522568,82.42956,11999,11754
162.158.110.253,46600,167.235.145.223,443,393,244872,133,262,123508,131,121364,0.209248,82.1707,12024,11815
162.158.111.2,26232,167.235.145.223,443,276,4983288,2851,130,11077,146,4972211,43.124247,34.379463,2577,1157018
162.158.111.3,55138,167.235.145.223,443,168,2707024,1578,81,7642,87,2699382,13.049212,64.89917,942,332747
162.158.111.17,24314,167.235.145.223,443,243,152280,106,162,77100,81,75180,0.171386,81.916517,7529,7342
162.158.111.18,11072,167.235.145.223,443,243,152913,9,162,77805,81,75108,0.005338,81.608062,7627,7362
162.158.111.25,49618,167.235.145.223,443,164,6333788,2277,63,6273,101,6327515,24.837018,40.960094,1225,1235839
162.158.111.30,18490,167.235.145.223,443,6,427,2560,2,132,4,295,29.473567,29.992801,35,78
162.158.111.33,59370,167.235.145.223,443,186,119553,671,124,61966,62,57587,1.399205,80.036002,6193,5756
162.158.111.34,52376,167.235.145.223,443,183,117409,675,122,60891,61,56518,1.4155,79.191897,6151,5709
162.158.111.44,32684,167.235.145.223,443,38,1248417,1009,13,1611,25,1246806,4.275121,60.008451,214,166217
162.158.111.45,32956,167.235.145.223,443,125,1455251,3441,62,5616,63,1449635,71.687691,0.053914,833327,215103312
162.158.111.46,22294,167.235.145.223,443,125,1455180,3436,61,5479,64,1449701,71.639618,0.051333,853875,225928895
162.158.111.49,22392,167.235.145.223,443,315,7377485,2513,141,12011,174,7365474,28.923847,30.894078,3110,1907284
162.158.111.67,24110,167.235.145.223,443,232,4151650,3102,114,9877,118,4141773,55.132455,4.509678,17521,7347350
162.158.111.76,57182,167.235.145.223,443,333,7778542,2924,150,12816,183,7765726,47.038712,31.119361,3294,1996371
162.158.111.77,62980,167.235.145.223,443,152,2555353,3500,72,7096,80,2548257,74.364174,3.923615,14468,5195733
162.158.111.87,15282,167.235.145.223,443,236,5076877,3314,117,11675,119,5065202,65.631664,16.873407,5535,2401507
162.158.111.94,54956,167.235.145.223,443,322,7416066,1443,143,12143,179,7403923,10.922039,60.615339,1602,977168
162.158.111.96,42980,167.235.145.223,443,158,2519474,1789,76,7208,82,2512266,16.715317,61.868224,932,324853
162.158.111.102,20262,167.235.145.223,443,225,4428446,2977,102,9085,123,4419361,49.100947,4.395935,16533,8042632
162.158.111.103,48720,167.235.145.223,443,126,79274,560,84,40286,42,38988,1.049185,81.867381,3936,3809
162.158.111.104,33950,167.235.145.223,443,129,81134,218,86,41212,43,39922,0.35747,82.695656,3986,3862
162.158.111.105,10156,167.235.145.223,443,38,1284835,1384,14,1912,24,1282923,9.627201,60.008722,254,171031
162.158.111.108,30584,167.235.145.223,443,138,2319301,2701,60,6206,78,2313095,35.307251,31.298148,1586,591241
162.158.111.113,9474,167.235.145.223,443,286,6094078,2797,135,11887,151,6082191,41.042246,30.861787,3081,1576627
162.158.111.123,51494,167.235.145.223,443,228,141682,456,152,71286,76,70396,0.804845,78.724659,7244,7153
162.158.111.123,55026,167.235.145.223,443,231,144223,295,154,72822,77,71401,0.485265,79.327123,7343,7200
162.158.111.129,11566,167.235.145.223,443,148,2386303,3141,72,7048,76,2379255,57.247418,6.805535,8285,2796846
162.158.111.130,29562,167.235.145.223,443,8,559,1841,4,264,4,295,17.397726,29.865568,70,79
162.158.111.140,12776,167.235.145.223,443,6,427,1119,2,132,4,295,5.411333,29.931064,35,78
162.158.111.143,38668,167.235.145.223,443,170,2725231,2896,86,7972,84,2717259,45.167622,8.027893,7944,2707817
162.158.111.147,17978,167.235.145.223,443,49,1312426,839,24,2337,25,1310089,2.117888,60.007846,311,174655
162.158.111.158,17670,167.235.145.223,443,237,147811,440,158,74552,79,73259,0.777363,81.687853,7301,7174
162.158.111.158,39904,167.235.145.223,443,237,147343,226,158,74158,79,73185,0.368277,81.831977,7249,7154
162.158.111.159,56004,167.235.145.223,443,157,2778645,3074,74,7192,83,2771453,53.651961,2.183262,26353,10155274
162.158.111.167,30444,167.235.145.223,443,420,1458165,333,274,121157,146,1337008,0.562342,81.601959,11877,131076
162.158.111.168,14102,167.235.145.223,443,422,1460809,140,275,122871,147,1337938,0.227092,82.631657,11895,129532
162.158.111.175,10824,167.235.145.223,443,6,427,1839,2,132,4,295,17.365296,29.971105,35,78
162.158.111.181,50092,167.235.145.223,443,411,259443,45,274,132535,137,126908,0.068454,81.428267,13021,12468
162.158.111.181,52514,167.235.145.223,443,411,259415,301,274,132420,137,126995,0.500454,81.249677,13038,12504
162.158.111.188,58200,167.235.145.223,443,232,4230033,2727,108,9481,124,4220552,37.104681,34.32235,2209,983744
162.158.111.191,25038,167.235.145.223,443,168,2881754,2545,81,7592,87,2874162,29.252558,31.337917,1938,733721
162.158.111.193,43136,167.235.145.223,443,251,4641070,3220,122,10405,129,4630665,61.117969,4.316884,19282,8581495
162.158.111.202,18260,167.235.145.223,443,148,2597211,3387,67,6718,81,2590493,69.330177,4.748925,11317,4363923
162.158.111.218,35302,167.235.145.223,443,88,2527839,1496,46,4681,42,2523158,11.482036,65.088051,575,310122
162.158.111.219,63628,167.235.145.223,443,6,427,1087,2,132,4,295,5.174749,29.991393,35,78
162.158.111.219,63634,167.235.145.223,443,6,427,1052,2,132,4,295,4.971606,29.969955,35,78
162.158.111.226,24244,167.235.145.223,443,286,5411068,2294,134,11197,152,5399871,25.102701,34.762759,2576,1242679
162.158.111.237,20126,167.235.145.223,443,345,211747,299,230,105207,115,106540,0.497305,81.779747,10291,10422
162.158.111.238,16562,167.235.145.223,443,348,215766,220,232,108223,116,107543,0.360771,82.427551,10503,10437
162.158.129.2,35436,167.235.145.223,443,489,301778,235,326,150537,163,151241,0.384755,82.171057,14655,14724
162.158.129.2,38120,167.235.145.223,443,486,299129,388,324,149026,162,150103,0.671329,81.316715,14661,14767
162.158.129.3,56756,167.235.145.223,443,486,300612,371,324,150530,162,150082,0.64529,80.916155,14882,14838
162.158.129.8,35186,167.235.145.223,443,192,1173394,1792,87,7209,105,1166185,16.736717,60.095407,959,155244
162.158.129.13,14892,167.235.145.223,443,462,9660267,3026,199,17373,263,9642894,52.162663,3.680358,37763,20960773
162.158.129.14,17976,167.235.145.223,443,259,4166980,3067,115,10755,144,4156225,53.297131,4.901477,17553,6783628
162.158.129.29,31420,167.235.145.223,443,486,10372939,2931,213,18218,273,10354721,47.096935,32.780754,4446,2527024
162.158.129.45,36498,167.235.145.223,443,294,4312531,3154,133,11214,161,4301317,57.853477,0.713674,125704,48216042
162.158.129.45,36504,167.235.145.223,443,321,4314359,3157,149,12316,172,4302043,58.032513,3.792069,25982,9075874
162.158.129.54,30768,167.235.145.223,443,349,6640698,2984,153,13139,196,6627559,49.294956,4.430926,23722,11966002
162.158.129.59,22952,167.235.145.223,443,191,1227528,3041,86,7143,105,1220385,52.777623,0.230852,247535,42291511
162.158.129.60,54508,167.235.145.223,443,173,1256478,3648,68,5955,105,1250523,82.822754,0.225808,210975,44303939
162.158.129.75,15140,167.235.145.223,443,49,1234137,1284,25,2466,24,1231671,7.873445,74.922419,263,131514
162.158.129.76,12392,167.235.145.223,443,82,1191118,40,41,3504,41,1187614,0.060667,60.024034,467,158285
162.158.129.82,32230,167.235.145.223,443,263,2320086,3606,120,9391,143,2310695,80.543466,0.275463,272733,67107234
162.158.129.82,63042,167.235.145.223,443,6,427,2241,2,132,4,295,24.24368,29.475824,35,80
162.158.129.84,24770,167.235.145.223,443,270,167370,447,180,83921,90,83449,0.790008,81.277869,8260,8213
162.158.129.84,24782,167.235.145.223,443,270,167636,399,180,84723,90,82913,0.692218,82.08963,8256,8080
162.158.129.84,54234,167.235.145.223,443,354,2818591,435,224,87259,130,2731332,0.769708,82.327235,8479,265412
162.158.129.84,54240,167.235.145.223,443,270,167633,455,180,84553,90,83080,0.803736,81.800357,8269,8125
162.158.129.84,60594,167.235.145.223,443,268,165283,12,179,82682,89,82601,0.008546,81.830102,8083,8075
162.158.129.85,23246,167.235.145.223,443,270,167307,425,180,84150,90,83157,0.746157,82.090346,8200,8103
162.158.129.85,30450,167.235.145.223,443,270,168847,61,180,85320,90,83527,0.09285,82.565702,8266,8093
162.158.129.99,27374,167.235.145.223,443,461,9431188,1739,214,18275,247,9412913,15.80781,63.989197,2284,1176812
162.158.129.100,43942,167.235.145.223,443,444,9164681,2141,198,17032,246,9147649,22.820122,33.034722,4124,2215281
162.158.129.103,31330,167.235.145.223,443,652,19525978,1026,257,24276,395,19501702,4.730785,57.420718,3382,2717026
162.158.129.104,22112,167.235.145.223,443,513,316495,193,342,158066,171,158429,0.311947,82.571174,15314,15349
162.158.129.104,44618,167.235.145.223,443,513,317637,75,342,159128,171,158509,0.120634,82.044621,15516,15455
162.158.129.104,65482,167.235.145.223,443,507,313513,283,338,156884,169,156629,0.459604,82.008999,15304,15279
162.158.129.104,65494,167.235.145.223,443,516,318034,223,344,158449,172,159585,0.366347,81.309053,15589,15701
162.158.129.111,34592,167.235.145.223,443,6,427,2471,2,132,4,295,28.195821,29.938576,35,78
162.158.129.112,51836,167.235.145.223,443,6,427,1859,2,132,4,295,17.779357,29.914288,35,78
162.158.129.116,56212,167.235.145.223,443,375,6958823,469,169,14211,206,6944612,0.827198,64.868953,1752,856448
162.158.129.121,24240,167.235.145.223,443,6,427,1156,2,132,4,295,6.102343,29.959156,35,78
162.158.129.122,12846,167.235.145.223,443,444,8465676,2663,209,17885,235,8447791,34.086033,33.728983,4242,2003687
162.158.129.126,61750,167.235.145.223,443,420,7185907,1230,195,15911,225,7169996,7.305391,64.411299,1976,890526
162.158.129.128,29054,167.235.145.223,443,297,4758673,3348,133,11162,164,4747511,67.352297,4.369161,20437,8692764
162.158.129.128,29056,167.235.145.223,443,220,2386414,3442,97,7710,123,2378704,71.712048,0.222068,277752,85692814
162.158.129.131,59820,167.235.145.223,443,7,493,2179,3,198,4,295,23.183393,29.660268,53,79
162.158.129.133,44626,167.235.145.223,443,6,427,2572,2,132,4,295,29.763115,29.937856,35,78
162.158.129.146,25316,167.235.145.223,443,46,1348446,1426,20,2136,26,1346310,10.743833,60.024098,284,179435
162.158.129.153,33494,167.235.145.223,443,284,4546699,3188,136,12957,148,4533742,59.246806,11.603529,8933,3125767
162.158.129.164,12542,167.235.145.223,443,293,4322892,2548,141,12471,152,4310421,29.265202,41.29956,2415,834957
162.158.129.166,36836,167.235.145.223,443,297,182180,427,198,90391,99,91789,0.748765,82.226013,8794,8930
162.158.129.166,36846,167.235.145.223,443,294,180836,538,196,90048,98,90788,1.002596,81.339453,8856,8929
162.158.129.167,9306,167.235.145.223,443,300,184428,508,200,91790,100,92638,0.940318,80.98907,9066,9150
162.158.129.167,35906,167.235.145.223,443,300,184182,253,200,91550,100,92632,0.418565,81.263156,9012,9119
162.158.129.167,55432,167.235.145.223,443,303,185360,138,202,91790,101,93570,0.224435,82.597246,8890,9062
162.158.129.169,53496,167.235.145.223,443,429,11474819,1032,166,16537,263,11458282,4.787333,73.290321,1805,1250727
162.158.129.170,32518,167.235.145.223,443,232,3884931,3300,103,9963,129,3874968,65.294834,5.438812,14654,5699727
162.158.129.174,28340,167.235.145.223,443,730,4525567,444,409,150885,321,4374682,0.787934,82.077522,14706,426395
162.158.129.174,40284,167.235.145.223,443,545,2396185,512,336,143183,209,2253002,0.945862,81.621741,14033,220823
162.158.129.175,33832,167.235.145.223,443,450,280804,288,300,141758,150,139046,0.468536,82.390032,13764,13501
162.158.129.175,62316,167.235.145.223,443,459,286720,257,306,144830,153,141890,0.423137,82.367673,14066,13781
162.158.129.179,51616,167.235.145.223,443,381,6380247,1939,166,14153,215,6366094,19.308083,34.689944,3263,1468112
162.158.129.183,31124,167.235.145.223,443,387,3651078,2824,157,13527,230,3637551,41.490209,35.529689,3045,819044
162.158.129.184,54144,167.235.145.223,443,173,1202247,3172,77,6549,96,1195698,58.795136,0.165233,317079,57891486
162.158.129.188,46996,167.235.145.223,443,840,2999000,179,517,195179,323,2803821,0.295063,82.361448,18958,272343
162.158.129.188,65354,167.235.145.223,443,411,1390268,2866,245,83626,166,1306642,43.529737,38.347758,17445,272587
162.158.129.189,22520,167.235.145.223,443,639,395331,52,426,197716,213,197615,0.079157,82.453603,19183,19173
162.158.129.189,60204,167.235.145.223,443,627,386653,119,418,192896,209,193757,0.19522,82.847389,18626,18709
162.158.129.216,30524,167.235.145.223,443,6,427,2510,2,132,4,295,28.887725,29.921426,35,78
162.158.129.220,29950,167.235.145.223,443,6,427,1159,2,132,4,295,6.137964,29.534806,35,79
162.158.129.229,35252,167.235.145.223,443,603,6241574,3113,234,18485,369,6223089,55.310041,4.483247,32985,11104610
162.158.129.231,53102,167.235.145.223,443,194,4107869,64,49,4922,145,4102947,0.096631,61.706666,638,531929
162.158.129.241,15640,167.235.145.223,443,564,348299,303,376,173912,188,174387,0.504147,81.967805,16973,17020
162.158.129.241,31002,167.235.145.223,443,564,348525,329,376,174350,188,174175,0.554135,82.407633,16925,16908
162.158.129.241,33250,167.235.145.223,443,567,349300,41,378,174429,189,174871,0.062239,83.021101,16808,16850
162.158.129.241,38962,167.235.145.223,443,566,351431,204,377,176336,189,175095,0.330172,82.772442,17042,16923
162.158.129.253,28618,167.235.145.223,443,554,7142393,2859,249,19475,305,7122918,43.342287,34.466101,4520,1653315
162.158.130.6,23576,167.235.145.223,443,282,3743515,2192,118,10881,164,3732634,23.286176,53.5363,1625,557772
162.158.130.10,40388,167.235.145.223,443,391,4094301,2950,143,12603,248,4081698,47.26544,34.208668,2947,954541
162.158.130.11,17788,167.235.145.223,443,259,2279231,3646,113,9892,146,2269339,82.653957,0.379606,208468,47825145
162.158.130.13,24638,167.235.145.223,443,201,1315565,3274,93,7605,108,1307960,64.813649,0.201736,301582,51868184
162.158.130.17,34216,167.235.145.223,443,440,4960657,1431,199,15173,241,4945484,10.785245,60.876226,1993,649906
162.158.130.17,34224,167.235.145.223,443,404,4958847,1452,176,14220,228,4944627,10.962772,62.851561,1809,629372
162.158.130.28,55716,167.235.145.223,443,189,5830997,790,91,9336,98,5821661,1.860062,71.65193,1042,649993
162.158.130.30,24928,167.235.145.223,443,540,8701025,3516,196,17083,344,8683942,76.170437,3.71777,36759,18686345
162.158.130.33,41466,167.235.145.223,443,385,8795345,1067,166,14972,219,8780373,5.037448,66.737396,1794,1052528
162.158.130.36,40032,167.235.145.223,443,249,1376001,2917,118,9255,131,1366746,46.78876,30.287882,2444,361001
162.158.130.46,64846,167.235.145.223,443,524,12224949,2601,203,18678,321,12206271,30.934285,34.892394,4282,2798609
162.158.130.47,44184,167.235.145.223,443,707,9129381,2681,255,21780,452,9107601,34.754811,39.187407,4446,1859291
162.158.130.51,59710,167.235.145.223,443,579,351901,279,386,173018,193,178883,0.452757,81.30952,17023,17600
162.158.130.52,20674,167.235.145.223,443,576,350633,339,384,172479,192,178154,0.571491,82.002857,16826,17380
162.158.130.52,58532,167.235.145.223,443,578,350797,38,385,171962,193,178835,0.056104,83.035805,16567,17229
162.158.130.55,27964,167.235.145.223,443,327,3484425,2699,147,12867,180,3471558,35.249742,39.185336,2626,708746
162.158.130.60,26050,167.235.145.223,443,6,427,2381,2,132,4,295,26.125526,29.671539,35,79
162.158.130.61,11768,167.235.145.223,443,6,427,1400,2,132,4,295,10.054038,29.707531,35,79
162.158.130.61,11778,167.235.145.223,443,7,493,1529,3,198,4,295,12.10164,29.590779,53,79
162.158.130.65,20058,167.235.145.223,443,39,1263584,1991,16,1872,23,1261712,19.867182,51.264077,292,196896
162.158.130.67,52632,167.235.145.223,443,6,427,1534,2,132,4,295,12.173955,29.945267,35,78
162.158.130.68,10140,167.235.145.223,443,6,427,1735,2,132,4,295,15.752304,29.50444,35,79
162.158.130.70,61452,167.235.145.223,443,6,427,2105,2,132,4,295,22.067502,29.820541,35,79
162.158.130.71,51572,167.235.145.223,443,391,4884991,3289,175,13554,216,4871437,65.186793,0.538803,201246,72329768
162.158.130.71,51580,167.235.145.223,443,382,4885002,3302,158,13036,224,4871966,65.34953,2.510248,41544,15526644
162.158.130.72,10522,167.235.145.223,443,6,427,754,2,132,4,295,1.675658,29.965472,35,78
162.158.130.73,42266,167.235.145.223,443,404,6888411,3475,184,15185,220,6873226,73.328668,4.44002,27360,12384135
162.158.130.76,29460,167.235.145.223,443,566,8020381,3396,223,18149,343,8002232,70.270926,3.629801,39999,17636739
162.158.130.76,29476,167.235.145.223,443,330,2686012,3434,153,11475,177,2674537,71.614205,0.299785,306219,71372136
162.158.162.18,55130,167.235.145.223,443,643,1402051,2983,278,19861,365,1382190,49.259197,31.647737,5020,349393
162.158.162.56,47220,167.235.145.223,443,6,427,2431,2,132,4,295,27.16679,28.921275,36,81
162.158.162.57,52252,167.235.145.223,443,706,1493586,3473,338,23821,368,1469765,73.275802,1.552333,122762,7574483
162.158.162.63,13328,167.235.145.223,443,692,1483638,2629,305,21643,387,1461995,31.730346,31.762903,5451,368227
162.158.162.119,44522,167.235.145.223,443,6,427,1101,2,132,4,295,5.290306,28.949496,36,81
162.158.162.170,17850,167.235.145.223,443,620,1123304,3223,296,21049,324,1102255,61.241354,1.640972,102617,5373668
162.158.162.173,56272,167.235.145.223,443,638,1275184,1227,299,21247,339,1253937,7.290315,60.631564,2803,165450
162.158.163.32,19922,167.235.145.223,443,6,427,1358,2,132,4,295,8.9627,28.966246,36,81
162.158.163.79,55932,167.235.145.223,443,680,1338201,3351,312,22105,368,1316096,67.425381,1.74556,101308,6031742
162.158.163.108,26324,167.235.145.223,443,893,2229124,3607,411,28639,482,2200485,80.576236,1.918688,119410,9174957
162.158.163.121,34702,167.235.145.223,443,587,1368247,1601,247,17815,340,1350432,13.415917,60.630702,2350,178184
162.158.163.127,38862,167.235.145.223,443,679,1274851,2309,321,22699,358,1252152,25.310008,31.810209,5708,314905
162.158.163.131,28588,167.235.145.223,443,6,427,880,2,132,4,295,2.451683,28.940945,36,81
162.158.163.153,21030,167.235.145.223,443,649,1254794,2860,298,21181,351,1233613,43.365436,31.72436,5341,311082
162.158.163.187,22338,167.235.145.223,443,180,1263942,1706,78,6010,102,1257932,14.874673,64.552301,744,155896
162.158.163.191,26584,167.235.145.223,443,45,28521,548,30,14625,15,13896,1.016211,79.443716,1472,1399
162.158.163.217,64214,167.235.145.223,443,829,2660342,3107,360,26135,469,2634207,55.249139,24.265307,8616,868468
162.158.163.222,46588,167.235.145.223,443,660,1234465,627,315,22303,345,1212162,1.25418,60.642784,2942,159908
162.158.163.233,52072,167.235.145.223,443,6,427,72,2,132,4,295,0.118206,29.050466,36,81
162.158.163.243,11474,167.235.145.223,443,2,132,58,1,66,1,66,0.091731,8.00E-06,,
162.158.178.37,10756,167.235.145.223,443,6,427,1813,2,132,4,295,17.107918,28.86264,36,81
162.158.178.62,18552,167.235.145.223,443,627,1123574,3258,289,20395,338,1103179,63.329234,1.91473,85213,4609230
162.158.178.72,51450,167.235.145.223,443,796,1490309,2650,385,26731,411,1463578,33.231186,31.966068,6689,366282
162.158.178.78,44228,167.235.145.223,443,656,1402717,3016,306,21517,350,1381200,51.261677,1.90388,90413,5803727
162.158.178.94,52002,167.235.145.223,443,7,493,2189,3,198,4,295,23.245361,28.804421,54,81
162.158.178.95,13352,167.235.145.223,443,619,1427405,3143,249,17755,370,1409650,57.331689,1.896336,74902,5946836
162.158.178.111,46378,167.235.145.223,443,7,493,2529,3,198,4,295,29.180681,28.791906,55,81
162.158.178.125,20156,167.235.145.223,443,615,1252358,2898,246,17557,369,1234801,45.212452,31.936849,4397,309310
162.158.178.180,42496,167.235.145.223,443,712,1376306,1716,316,22177,396,1354129,15.203089,60.767777,2919,178269
162.158.178.186,30416,167.235.145.223,443,6,427,1084,2,132,4,295,5.151067,28.849006,36,81
162.158.178.227,45780,167.235.145.223,443,653,1200635,2775,290,20461,363,1180174,39.296627,32.004386,5114,295003
162.158.178.234,19372,167.235.145.223,443,597,1332531,3386,240,17161,357,1315370,69.318303,2.143709,64042,4908763
162.158.178.251,46054,167.235.145.223,443,669,1267983,3616,293,20659,376,1247324,81.205494,1.727048,95696,5777831
162.158.179.34,32744,167.235.145.223,443,625,1271095,2433,268,19009,357,1252086,27.180629,31.864022,4772,314357
162.158.179.37,53600,167.235.145.223,443,721,1280470,1367,332,23233,389,1257237,9.171432,60.830971,3055,165341
162.158.179.51,61476,167.235.145.223,443,706,1237310,944,336,23497,370,1213813,3.260695,60.81838,3090,159663
162.158.179.80,12826,167.235.145.223,443,42,23933,906,28,10962,14,12971,2.693256,78.231445,1120,1326
162.158.179.113,54596,167.235.145.223,443,665,1300896,2074,298,20989,367,1279907,21.26903,60.743829,2764,168564
162.158.179.126,15228,167.235.145.223,443,6,427,1462,2,132,4,295,11.023079,28.8984,36,81
162.158.179.149,26436,167.235.145.223,443,676,1491414,3508,277,19603,399,1471811,75.209521,1.840394,85212,6397808
162.158.186.21,62680,167.235.145.223,443,39,24245,1081,26,12194,13,12051,5.127591,72.241994,1350,1334
162.158.186.30,23412,167.235.145.223,443,6,427,1583,2,132,4,295,13.136983,28.827749,36,81
162.158.186.46,30720,167.235.145.223,443,918,2375382,3306,443,30714,475,2344668,65.39623,1.797713,136680,10434003
162.158.186.70,21204,167.235.145.223,443,810,2109102,2196,360,25236,450,2083866,23.332017,31.780301,6352,524567
162.158.186.97,17554,167.235.145.223,443,6,427,2567,2,132,4,295,29.6488,29.832604,35,79
162.158.186.103,54076,167.235.145.223,443,874,2429746,2952,401,27942,473,2401804,47.376254,31.741408,7042,605342
162.158.186.119,39396,167.235.145.223,443,901,2823264,2550,408,28404,493,2794860,29.342024,31.809412,7143,702901
162.158.186.123,51018,167.235.145.223,443,6,427,1216,2,132,4,295,7.111851,28.839744,36,81
162.158.186.128,26844,167.235.145.223,443,928,2376073,1106,443,30714,485,2345359,5.322932,60.644352,4051,309391
162.158.186.146,15478,167.235.145.223,443,754,1807092,2702,337,23718,417,1783374,35.355655,31.621946,6000,451173
162.158.186.188,48382,167.235.145.223,443,929,2472569,1486,446,30912,483,2441657,11.330004,60.63921,4078,322122
162.158.186.210,10776,167.235.145.223,443,886,2267816,3070,421,29262,465,2238554,53.391399,1.732329,135133,10337777
162.158.186.228,24874,167.235.145.223,443,896,2178093,1837,423,29394,473,2148699,17.351801,60.66429,3876,283356
162.158.186.236,49840,167.235.145.223,443,854,2166266,2822,393,27414,461,2138852,41.364659,31.844475,6886,537324
162.158.186.240,62756,167.235.145.223,443,7,493,1926,3,198,4,295,19.178444,28.822264,54,81
162.158.186.245,56436,167.235.145.223,443,6,427,2293,2,132,4,295,25.102342,28.843212,36,81
162.158.187.18,54858,167.235.145.223,443,801,2123577,3193,378,26424,423,2097153,59.378163,1.910561,110643,8781307
162.158.187.40,49858,167.235.145.223,443,889,2349375,3553,428,29724,461,2319651,77.4039,1.723094,138002,10769701
162.158.187.57,19704,167.235.145.223,443,6,427,583,2,132,4,295,1.111248,28.848305,36,81
162.158.187.82,10582,167.235.145.223,443,918,2432650,3431,429,29790,489,2402860,71.401804,1.802221,132236,10666216
162.158.202.5,44556,167.235.145.223,443,223,2043404,2832,117,9343,106,2034061,41.80352,30.149255,2479,539731
162.158.202.15,64902,167.235.145.223,443,246,2448689,3315,129,10135,117,2438554,65.657674,0.136546,593792,142870768
162.158.202.16,56686,167.235.145.223,443,242,2255626,1135,117,9343,125,2246283,5.64799,60.071906,1244,299145
162.158.202.25,30932,167.235.145.223,443,220,2302358,2215,106,8617,114,2293741,23.637975,30.141841,2287,608785
162.158.202.49,28288,167.235.145.223,443,237,2128697,2705,125,9871,112,2118826,35.667735,30.406978,2597,557457
162.158.202.62,21648,167.235.145.223,443,6,427,2583,2,132,4,295,30.104849,29.595972,35,79
162.158.202.73,51200,167.235.145.223,443,250,2494161,2566,121,9607,129,2484554,29.647347,30.356465,2531,654767
162.158.202.93,59534,167.235.145.223,443,228,2164257,3200,109,8815,119,2155442,59.667106,0.207956,339110,82919155
162.158.202.96,41648,167.235.145.223,443,82,2354437,1516,39,3544,43,2350893,11.860854,65.811707,430,285772
162.158.202.118,36470,167.235.145.223,443,6,427,2224,2,132,4,295,23.819069,29.88892,35,78
162.158.202.143,53416,167.235.145.223,443,258,2606188,2956,133,10399,125,2595789,47.641668,30.217221,2753,687234
162.158.203.40,21032,167.235.145.223,443,7,493,1160,3,198,4,295,6.140323,29.557547,53,79
162.158.203.62,51598,167.235.145.223,443,249,2680910,3440,124,9805,125,2671105,71.679549,0.145399,539481,146966897
162.158.203.84,29786,167.235.145.223,443,244,2427473,3075,126,9937,118,2417536,53.662115,0.138865,572469,139274028
162.158.203.88,48944,167.235.145.223,443,6,427,1868,2,132,4,295,17.936979,29.803139,35,79
162.158.203.91,26206,167.235.145.223,443,6,427,49,2,132,4,295,0.077572,29.617252,35,79
162.158.203.118,34758,167.235.145.223,443,39,26122,1128,26,14079,13,12043,5.500535,72.023422,1563,1337
162.158.203.127,33398,167.235.145.223,443,285,2487478,1506,154,11785,131,2475693,11.654905,60.066304,1569,329728
162.158.203.138,38478,167.235.145.223,443,234,2185738,3559,117,9343,117,2176395,77.657261,0.165273,452245,105347878
162.158.222.19,40650,167.235.145.223,443,315,2335635,3259,152,11559,163,2324076,63.380532,0.307237,300979,60515523
162.158.222.23,20674,167.235.145.223,443,310,2784309,2453,148,11295,162,2773014,27.742758,30.368207,2975,730504
162.158.222.24,40510,167.235.145.223,443,373,4745633,951,170,13623,203,4732010,3.382032,66.001221,1651,573566
162.158.222.28,54296,167.235.145.223,443,6,427,2090,2,132,4,295,21.696652,29.685848,35,79
162.158.222.41,18804,167.235.145.223,443,402,4247318,1549,204,15866,198,4231452,12.40773,51.325459,2473,659548
162.158.222.46,24326,167.235.145.223,443,344,4068775,3309,170,13691,174,4055084,65.52644,6.773132,16170,4789611
162.158.222.63,40956,167.235.145.223,443,312,2190826,3572,157,11923,155,2178903,78.238436,0.308481,309205,56506637
162.158.222.71,47548,167.235.145.223,443,399,4870877,2591,194,15206,205,4855671,30.421572,45.060443,2699,862072
162.158.222.77,64098,167.235.145.223,443,310,2308203,2254,148,11294,162,2296909,24.437201,30.311859,2980,606207
162.158.222.83,19132,167.235.145.223,443,313,2139666,1721,154,11691,159,2127975,15.366352,60.119792,1555,283164
162.158.222.86,44682,167.235.145.223,443,319,2453448,3330,156,11857,163,2441591,66.21863,0.308027,307947,63412389
162.158.222.90,11764,167.235.145.223,443,42,26268,323,28,13300,14,12968,0.541334,78.087743,1362,1328
162.158.222.90,60084,167.235.145.223,443,42,26017,345,28,13048,14,12969,0.58002,78.131922,1335,1327
162.158.222.102,14412,167.235.145.223,443,7,493,1193,3,198,4,295,6.711769,29.814208,53,79
162.158.222.103,55840,167.235.145.223,443,297,2129555,2778,143,10965,154,2118590,39.37895,30.309823,2894,559182
162.158.222.107,53524,167.235.145.223,443,369,3311041,3017,195,15307,174,3295734,51.3699,14.691938,8334,1794580
162.158.222.110,18840,167.235.145.223,443,409,4901676,2968,203,15800,206,4885876,48.418353,26.980088,4684,1448735
162.158.222.124,11030,167.235.145.223,443,323,2324102,3618,163,12285,160,2311817,81.380344,0.305258,321957,60586572
162.158.222.124,52136,167.235.145.223,443,7,493,1732,3,198,4,295,15.672592,29.812653,53,79
162.158.222.130,53544,167.235.145.223,443,6,427,1902,2,132,4,295,18.711736,29.81234,35,79
162.158.222.145,64196,167.235.145.223,443,296,2090298,3144,143,10965,153,2079333,57.375292,0.302309,290166,55025368
162.158.222.146,54272,167.235.145.223,443,84,53624,216,56,27678,28,25946,0.35449,80.988061,2734,2562
162.158.222.149,61088,167.235.145.223,443,6,427,2271,2,132,4,295,24.707663,29.81351,35,79
162.158.222.152,61450,167.235.145.223,443,137,4381396,1892,66,6106,71,4375290,18.412087,54.314782,899,644434
162.158.222.163,43402,167.235.145.223,443,294,2072119,248,145,11096,149,2061023,0.411603,60.121604,1476,274247
162.158.222.184,48992,167.235.145.223,443,6,427,1386,2,132,4,295,9.66532,29.807847,35,79
162.158.222.196,10654,167.235.145.223,443,6,427,975,2,132,4,295,3.669056,29.811519,35,79
162.158.222.196,46280,167.235.145.223,443,310,2392573,3388,154,11691,156,2380882,69.379085,0.349883,267312,54438357
162.158.222.199,31718,167.235.145.223,443,99,62600,729,66,31956,33,30644,1.586661,79.675477,3208,3076
162.158.222.208,22552,167.235.145.223,443,311,2076250,2079,155,11757,156,2064493,21.362784,60.121503,1564,274709
162.158.222.213,20106,167.235.145.223,443,6,427,2446,2,132,4,295,27.662904,29.811259,35,79
162.158.222.218,21438,167.235.145.223,443,292,2168386,3215,139,10700,153,2157686,60.43257,0.346225,247238,49856272
162.158.222.239,21922,167.235.145.223,443,84,49708,824,56,23758,28,25950,2.026677,80.468733,2361,2579
162.158.222.246,64756,167.235.145.223,443,327,2432856,3092,161,12152,166,2420704,54.423711,0.30813,315503,62848901
162.158.222.248,11316,167.235.145.223,443,291,2258765,1174,132,10238,159,2248527,6.411777,60.119283,1362,299208
162.158.223.7,33890,167.235.145.223,443,6,427,408,2,132,4,295,0.709076,29.813299,35,79
162.158.223.10,35444,167.235.145.223,443,316,2133816,2714,160,12086,156,2121730,36.424423,30.452724,3175,557383
165.154.24.48,46056,167.235.145.223,22,26,4644,3461,12,2050,14,2594,72.696421,3.903874,4200,5315
167.235.145.223,443,43.249.73.27,22230,4,333,2117,2,201,2,132,22.510482,0.210293,7646,5021
167.235.145.223,443,43.249.73.29,33502,4,333,1368,2,201,2,132,9.19554,0.219043,7341,4820
167.235.145.223,443,43.249.73.37,20236,4,333,545,2,201,2,132,1.010379,0.207996,7730,5077
167.235.145.223,443,43.249.74.26,13358,4,333,3062,2,201,2,132,53.220435,0.216583,7424,4875
167.235.145.223,443,43.249.74.27,53248,4,333,1348,2,201,2,132,8.837592,0.225305,7136,4686
167.235.145.223,443,43.249.74.34,59728,4,333,2134,2,201,2,132,22.751527,0.223272,7201,4729
167.235.145.223,443,43.249.74.40,37934,4,333,1738,2,201,2,132,15.775537,0.220995,7276,4778
167.235.145.223,443,43.249.74.41,14370,4,333,2821,2,201,2,132,41.298772,0.224101,7175,4712
167.235.145.223,443,43.249.74.46,21014,4,333,2497,2,201,2,132,28.676505,0.223636,7190,4721
167.235.145.223,443,43.249.74.59,10924,4,333,910,2,201,2,132,2.757457,0.216764,7418,4871
167.235.145.223,443,43.249.74.70,42274,4,333,2951,2,201,2,132,47.359391,0.219964,7310,4800
167.235.145.223,22,85.73.250.195,54349,1049,106662,6,689,85494,360,21168,0.003087,82.75064,8265,2046
167.235.145.223,443,104.156.92.36,31770,7,588,2635,3,255,4,333,32.200647,12.01825,169,221
167.235.145.223,443,104.156.92.37,21352,4,333,3131,2,201,2,132,56.202437,0.012356,130139,85464
167.235.145.223,443,104.156.92.48,40024,4,333,3004,2,201,2,132,50.259522,0.015512,103661,68076
167.235.145.223,443,104.156.92.49,47722,7,588,2759,3,255,4,333,38.271524,21.769981,93,122
167.235.145.223,443,104.156.92.62,8648,7,588,1311,3,255,4,333,8.260743,47.512238,42,56
167.235.145.223,443,104.156.92.76,60846,4,333,2884,2,201,2,132,44.275375,0.01905,84409,55433
167.235.145.223,443,104.156.92.77,17324,4,333,2390,2,201,2,132,26.276442,0.019063,84351,55395
167.235.145.223,22,106.12.167.196,47984,7,462,3137,7,462,0,0,56.800111,25.263705,146,0
167.235.145.223,443,108.162.220.83,24446,4,295,2369,3,229,1,66,25.972594,0.011964,153126,44132
167.235.145.223,443,108.162.220.84,15656,4,295,2347,3,229,1,66,25.774497,0.01228,149185,42996
167.235.145.223,443,108.162.220.97,39816,5,361,2002,3,229,2,132,20.018325,0.012401,147730,85154
167.235.145.223,443,108.162.220.114,20032,4,295,1178,3,229,1,66,6.523425,0.012125,151092,43546
167.235.145.223,443,108.162.220.115,53984,4,295,1035,3,229,1,66,4.825539,0.012063,151869,43770
167.235.145.223,443,108.162.221.11,47732,4,295,1639,3,229,1,66,13.737398,0.012074,151730,43730
167.235.145.223,443,108.162.221.17,24576,4,295,1268,3,229,1,66,7.742364,0.012134,150980,43514
167.235.145.223,443,108.162.221.41,37516,4,295,1979,3,229,1,66,19.76534,0.011921,153678,44291
167.235.145.223,443,108.162.221.45,14594,5,361,284,3,229,2,132,0.461469,0.011883,154169,88866
167.235.145.223,443,108.162.221.56,24624,4,295,170,3,229,1,66,0.282402,0.012051,152020,43813
167.235.145.223,443,108.162.221.58,12368,4,295,2267,3,229,1,66,24.676511,0.012066,151831,43759
167.235.145.223,443,108.162.221.77,30462,4,295,2075,3,229,1,66,21.26945,0.01211,151279,43600
167.235.145.223,443,108.162.221.172,61580,4,295,1370,3,229,1,66,9.290407,0.020539,89196,25707
167.235.145.223,443,108.162.241.8,64234,4,295,2361,3,229,1,66,25.869452,0.100908,18155,5232
167.235.145.223,443,108.162.241.79,13314,4,295,1015,3,229,1,66,4.463466,0.111336,16454,4742
167.235.145.223,443,108.162.241.181,29846,5,361,1992,3,229,2,132,19.884638,0.111232,16470,9493
167.235.145.223,443,108.162.241.187,9998,4,295,1278,3,229,1,66,7.850351,0.101297,18085,5212
167.235.145.223,443,108.162.241.190,35744,4,295,1412,3,229,1,66,10.43565,0.101192,18104,5217
167.235.145.223,443,108.162.242.28,28308,4,295,1650,3,229,1,66,13.875597,0.110184,16626,4791
167.235.145.223,443,108.162.242.42,47194,4,295,2483,3,229,1,66,28.494921,0.113896,16084,4635
167.235.145.223,443,108.162.242.65,9888,4,295,793,3,229,1,66,1.871427,0.110494,16580,4778
167.235.145.223,443,140.248.69.23,65110,4,333,2634,2,201,2,132,32.131558,0.021298,75500,49582
167.235.145.223,443,140.248.69.25,59222,7,588,739,3,255,4,333,1.626392,42.288869,48,62
167.235.145.223,443,140.248.69.30,43010,4,333,1657,2,201,2,132,13.971541,0.020984,76629,50324
167.235.145.223,443,140.248.69.47,34000,4,333,2754,2,201,2,132,37.967364,0.021101,76204,50045
167.235.145.223,443,140.248.69.49,15248,4,333,2879,2,201,2,132,44.005437,0.018815,85463,56125
167.235.145.223,443,140.248.69.51,31832,4,333,2331,2,201,2,132,25.62246,0.021193,75874,49827
167.235.145.223,443,140.248.69.59,61008,7,588,1283,3,255,4,333,7.866437,17.743685,114,150
167.235.145.223,443,140.248.74.42,19290,4,333,2658,2,201,2,132,33.916486,0.003765,,
167.235.145.223,443,140.248.74.45,62234,4,333,683,2,201,2,132,1.438871,0.003776,,
167.235.145.223,443,140.248.74.60,27370,4,333,2585,2,201,2,132,30.181189,0.003671,,
167.235.145.223,443,140.248.74.67,25750,4,333,2499,2,201,2,132,28.715515,0.003733,,
167.235.145.223,443,140.248.74.72,51578,4,333,3168,2,201,2,132,58.708797,0.0037,,
167.235.145.223,443,140.248.74.77,59974,4,333,2914,2,201,2,132,46.61348,0.003719,,
167.235.145.223,443,140.248.74.79,44066,4,333,2791,2,201,2,132,40.776467,0.003719,,
167.235.145.223,443,140.248.74.81,8598,4,333,2726,2,201,2,132,37.103406,0.003689,,
167.235.145.223,443,140.248.74.95,23182,4,333,2053,2,201,2,132,20.741468,0.00374,,
167.235.145.223,443,140.248.74.105,6562,7,588,1423,3,255,4,333,10.651471,48.124652,42,55
167.235.145.223,443,140.248.74.114,18220,4,333,3203,2,201,2,132,59.732466,0.003667,,
167.235.145.223,443,140.248.74.124,7910,4,333,3044,2,201,2,132,52.806444,0.003626,,
167.235.145.223,443,140.248.75.27,21668,4,333,2136,2,201,2,132,22.768497,0.003379,,
167.235.145.223,443,140.248.75.36,9472,4,333,2491,2,201,2,132,28.593522,0.003389,,
167.235.145.223,443,140.248.75.40,30132,4,333,2911,2,201,2,132,46.547494,0.003446,,
167.235.145.223,443,140.248.75.42,51252,4,333,1023,2,201,2,132,4.630506,0.003418,,
167.235.145.223,443,140.248.75.77,41138,4,333,2891,2,201,2,132,44.673396,0.003409,,
167.235.145.223,443,140.248.75.104,25960,7,588,1458,3,255,4,333,10.998408,35.597531,57,74
167.235.145.223,443,140.248.83.21,31074,4,333,2607,2,201,2,132,31.09644,0.021313,75446,49547
167.235.145.223,443,140.248.83.43,19550,4,333,2974,2,201,2,132,48.86755,0.021371,75242,49412
167.235.145.223,443,140.248.83.44,51870,4,333,3047,2,201,2,132,52.93248,0.021425,75052,49288
167.235.145.223,443,140.248.83.53,10316,4,333,2848,2,201,2,132,42.875493,0.020831,77192,50693
167.235.145.223,443,140.248.83.54,50278,4,333,2719,2,201,2,132,36.844531,0.01867,86127,56561
167.235.145.223,443,140.248.83.57,19076,7,588,2337,3,255,4,333,25.657483,33.06063,61,80
167.235.145.223,443,140.248.83.59,45606,4,333,650,2,201,2,132,1.328505,0.021214,75799,49778
167.235.145.223,443,140.248.83.60,23022,4,333,1150,2,201,2,132,6.014633,0.018915,85011,55828
167.235.145.223,443,140.248.83.66,33710,7,588,1877,3,255,4,333,18.173623,11.25399,181,236
167.235.145.223,443,140.248.83.74,14478,4,333,1408,2,201,2,132,10.344511,0.018966,84783,55678
167.235.145.223,443,141.101.76.22,64448,5,361,2305,3,229,2,132,25.288541,0.009771,187493,108074
167.235.145.223,443,141.101.76.28,30420,4,295,2019,3,229,1,66,20.244409,0.009997,183254,52815
167.235.145.223,443,141.101.76.45,31344,4,295,1616,3,229,1,66,13.533396,0.009367,195580,56368
167.235.145.223,443,141.101.76.65,46486,4,295,693,3,229,1,66,1.483389,0.009945,184213,53092
167.235.145.223,443,141.101.76.142,22266,4,295,1421,3,229,1,66,10.617562,0.009445,193965,55902
167.235.145.223,443,141.101.76.172,35928,4,295,1595,3,229,1,66,13.330423,0.009944,184231,53097
167.235.145.223,443,141.101.76.177,45224,4,295,849,3,229,1,66,2.205371,0.009678,189295,54556
167.235.145.223,443,141.101.76.199,62206,4,295,1226,3,229,1,66,7.288715,0.009542,191993,55334
167.235.145.223,443,141.101.76.207,21794,5,361,1678,3,229,2,132,14.212479,0.009417,194541,112137
167.235.145.223,443,141.101.77.27,25696,4,295,2387,3,229,1,66,26.215444,0.010178,179996,51876
167.235.145.223,443,141.101.77.51,56580,4,295,632,3,229,1,66,1.26137,0.009498,192882,55590
167.235.145.223,443,141.101.77.53,21134,4,295,1950,3,229,1,66,19.50844,0.009504,192760,55555
167.235.145.223,443,141.101.96.56,16036,4,295,1024,3,229,1,66,4.638957,0.015878,115379,33253
167.235.145.223,443,141.101.96.58,16050,4,295,2500,3,229,1,66,28.720007,0.014178,129214,37240
167.235.145.223,443,141.101.96.75,47390,4,295,1786,3,229,1,66,16.699542,0.018088,101282,29190
167.235.145.223,443,141.101.96.117,37104,4,295,1424,3,229,1,66,10.687667,0.012821,142890,41182
167.235.145.223,443,141.101.96.218,47454,4,295,2131,3,229,1,66,22.714481,0.014771,124026,35745
167.235.145.223,443,141.101.98.76,63620,4,295,1194,3,229,1,66,6.729378,0.020109,91103,26256
167.235.145.223,443,141.101.98.77,38886,4,295,1187,3,229,1,66,6.631366,0.020137,90976,26220
167.235.145.223,443,141.101.98.120,31662,4,295,1561,3,229,1,66,12.648321,0.021845,83863,24170
167.235.145.223,443,141.101.98.121,15162,4,295,1573,3,229,1,66,12.868333,0.020083,91221,26290
167.235.145.223,443,141.101.98.169,12496,4,295,2281,3,229,1,66,24.908464,0.021709,84388,24321
167.235.145.223,443,141.101.98.205,23024,4,295,1900,3,229,1,66,18.651476,0.021813,83986,24205
167.235.145.223,443,141.101.98.205,23032,4,295,1909,3,229,1,66,18.891403,0.020902,87647,25260
167.235.145.223,443,141.101.99.87,26890,4,295,381,3,229,1,66,0.658523,0.020155,90895,26196
167.235.145.223,443,141.101.99.87,26860,4,295,383,3,229,1,66,0.660464,0.021135,86680,24982
167.235.145.223,443,141.101.104.80,60008,4,295,1540,3,229,1,66,12.250476,0.009501,192821,55573
167.235.145.223,443,141.101.104.85,34822,4,295,1855,3,229,1,66,17.698435,0.009604,190753,54977
167.235.145.223,443,141.101.104.91,30918,5,361,1138,3,229,2,132,5.685143,0.009333,196292,113146
167.235.145.223,443,141.101.104.111,30982,5,361,2568,3,229,2,132,29.658907,0.009652,189805,109407
167.235.145.223,443,141.101.104.121,53858,4,295,1521,3,229,1,66,11.917402,0.009323,196503,56634
167.235.145.223,443,141.101.105.98,12696,4,295,2235,3,229,1,66,24.137969,0.009359,195747,56416
167.235.145.223,443,141.101.105.113,21346,4,295,2220,3,229,1,66,23.70248,0.009583,191171,55097
167.235.145.223,443,141.101.105.141,57440,4,295,1143,3,229,1,66,5.841587,0.009326,196440,56615
167.235.145.223,443,157.52.78.20,54736,7,588,1610,3,255,4,333,13.491624,13.089634,155,203
167.235.145.223,443,157.52.78.23,52772,4,333,785,2,201,2,132,1.84152,0.044602,36052,23676
167.235.145.223,443,157.52.78.28,43362,7,588,1354,3,255,4,333,8.901478,34.414201,59,77
167.235.145.223,443,157.52.78.29,44032,7,588,2060,3,255,4,333,20.910468,3.587587,568,742
167.235.145.223,443,157.52.78.31,21738,7,588,2751,3,255,4,333,37.952058,16.151873,126,164
167.235.145.223,443,157.52.106.20,38160,7,588,2648,3,255,4,333,33.03346,3.027746,673,879
167.235.145.223,443,157.52.106.21,31880,7,588,2839,3,255,4,333,42.262478,20.768584,98,128
167.235.145.223,443,157.52.106.25,53100,7,588,929,3,255,4,333,3.036453,38.248659,53,69
167.235.145.223,443,157.52.106.36,22242,4,333,2731,2,201,2,132,37.285571,0.027187,59145,38842
167.235.145.223,443,157.52.106.36,49434,4,333,2899,2,201,2,132,45.449246,0.027025,59500,39074
167.235.145.223,443,157.52.106.39,37162,4,333,3020,2,201,2,132,51.458408,0.027425,58632,38505
167.235.145.223,443,162.158.18.38,24816,4,295,1489,3,229,1,66,11.368412,0.032865,55743,16065
167.235.145.223,443,162.158.18.45,55174,4,295,1031,3,229,1,66,4.778517,0.032353,56625,16319
167.235.145.223,443,162.158.18.49,20876,4,295,2332,3,229,1,66,25.632491,0.034684,52819,15223
167.235.145.223,443,162.158.18.49,20898,4,295,2367,3,229,1,66,25.949369,0.034618,52920,15252
167.235.145.223,443,162.158.18.95,46986,5,361,2072,3,229,2,132,21.189465,0.034676,52831,30453
167.235.145.223,443,162.158.18.105,55336,4,295,1632,3,229,1,66,13.671673,0.029925,61219,17644
167.235.145.223,443,162.158.18.130,22646,5,361,1262,3,229,2,132,7.687388,0.032509,56353,32483
167.235.145.223,443,162.158.18.173,30616,4,295,2397,3,229,1,66,26.379441,0.032299,56720,16347
167.235.145.223,443,162.158.18.180,42484,4,295,1966,3,229,1,66,19.655337,0.034753,52714,15192
167.235.145.223,443,162.158.18.185,16910,5,361,1450,3,229,2,132,10.946757,0.034524,53064,30587
167.235.145.223,443,162.158.18.187,27586,6,427,1455,3,229,3,198,10.985369,0.034674,52834,45682
167.235.145.223,443,162.158.19.92,44794,4,295,1591,3,229,1,66,13.253505,0.032294,56728,16349
167.235.145.223,443,162.158.19.126,13076,4,295,1988,3,229,1,66,19.838342,0.034623,52912,15249
167.235.145.223,443,162.158.19.164,11380,4,295,727,3,229,1,66,1.585423,0.032187,56917,16404
167.235.145.223,443,162.158.22.25,12334,5,361,1987,3,229,2,132,19.823401,0.018385,99646,57438
167.235.145.223,443,162.158.22.29,35104,4,295,1646,3,229,1,66,13.836387,0.019475,94069,27111
167.235.145.223,443,162.158.22.33,61280,4,295,2359,3,229,1,66,25.859397,0.018694,97999,28244
167.235.145.223,443,162.158.22.117,48552,4,295,1275,3,229,1,66,7.824407,0.018633,98320,28336
167.235.145.223,443,162.158.22.210,41946,4,295,787,3,229,1,66,1.843398,0.020162,90864,26187
167.235.145.223,443,162.158.33.136,34968,4,295,646,3,229,1,66,1.314398,0.023397,78300,22566
167.235.145.223,443,162.158.60.133,23158,4,295,1337,3,229,1,66,8.615556,0.031065,58973,16996
167.235.145.223,443,162.158.60.137,57186,4,295,2412,3,229,1,66,26.654556,0.030851,59382,17114
167.235.145.223,443,162.158.62.33,16358,4,295,1287,3,229,1,66,7.890692,0.084303,21731,6263
167.235.145.223,443,162.158.62.186,9322,4,295,797,3,229,1,66,1.89243,0.082354,22245,6411
167.235.145.223,443,162.158.62.205,34304,5,361,1653,3,229,2,132,13.911346,0.084196,21758,12542
167.235.145.223,443,162.158.62.249,33930,5,361,2363,3,229,2,132,25.887569,0.082306,22258,12830
167.235.145.223,443,162.158.63.132,61960,5,361,1993,3,229,2,132,19.89937,0.084172,21764,12545
167.235.145.223,443,162.158.74.31,48032,4,295,1686,3,229,1,66,14.448492,0.021335,85868,24748
167.235.145.223,443,162.158.74.36,59926,4,295,2396,3,229,1,66,26.37241,0.04268,42924,12371
167.235.145.223,443,162.158.74.41,43642,5,361,2038,3,229,2,132,20.569396,0.042127,43487,25067
167.235.145.223,443,162.158.74.65,60798,4,295,1487,3,229,1,66,11.347416,0.02352,77891,22448
167.235.145.223,443,162.158.74.111,38626,4,295,836,3,229,1,66,2.10135,0.04113,44541,12837
167.235.145.223,443,162.158.86.86,55844,4,295,2115,3,229,1,66,22.472529,0.004032,,
167.235.145.223,443,162.158.86.127,15064,4,295,881,3,229,1,66,2.452461,0.00414,,
167.235.145.223,443,162.158.86.162,60930,4,295,1328,3,229,1,66,8.445465,0.004128,,
167.235.145.223,443,162.158.86.233,11994,6,427,1687,3,229,3,198,14.450416,0.004262,,
167.235.145.223,443,162.158.87.50,48666,5,361,1664,3,229,2,132,14.007421,0.004122,,
167.235.145.223,443,162.158.87.88,16782,4,295,2402,3,229,1,66,26.457498,0.004067,,
167.235.145.223,443,162.158.87.108,24292,4,295,2482,3,229,1,66,28.488447,0.004131,,
167.235.145.223,443,162.158.87.132,47500,4,295,1296,3,229,1,66,8.013351,0.004132,,
167.235.145.223,443,162.158.87.169,48718,5,361,919,3,229,2,132,2.82942,0.004087,,
167.235.145.223,443,162.158.87.195,40076,4,295,1413,3,229,1,66,10.486514,0.004103,,
167.235.145.223,443,162.158.94.77,15084,4,295,2001,3,229,1,66,20.010463,0.004106,,
167.235.145.223,443,162.158.94.83,22610,5,361,861,3,229,2,132,2.267732,0.004362,,
167.235.145.223,443,162.158.94.122,12842,4,295,1634,3,229,1,66,13.709443,0.004277,,
167.235.145.223,443,162.158.94.179,32394,4,295,1265,3,229,1,66,7.729395,0.004107,,
167.235.145.223,443,162.158.94.191,18622,4,295,733,3,229,1,66,1.599625,0.004059,,
167.235.145.223,443,162.158.94.210,54628,4,295,2368,3,229,1,66,25.96852,0.004053,,
167.235.145.223,443,162.158.94.212,13574,4,295,715,3,229,1,66,1.550377,0.004035,,
167.235.145.223,443,162.158.94.218,37204,4,295,1728,3,229,1,66,15.460444,0.004043,,
167.235.145.223,443,162.158.94.244,57874,5,361,2438,3,229,2,132,27.236379,0.004062,,
167.235.145.223,443,162.158.95.65,24238,4,295,1274,3,229,1,66,7.816378,0.004059,,
167.235.145.223,443,162.158.95.69,28908,4,295,2343,3,229,1,66,25.729453,0.004167,,
167.235.145.223,443,162.158.95.77,30770,5,361,2389,3,229,2,132,26.26356,0.004029,,
167.235.145.223,443,162.158.95.137,21152,5,361,766,3,229,2,132,1.721464,0.003939,,
167.235.145.223,443,162.158.95.163,18466,4,295,2023,3,229,1,66,20.289358,0.00398,,
167.235.145.223,443,162.158.95.194,37798,5,361,1680,3,229,2,132,14.267642,0.003959,,
167.235.145.223,443,162.158.95.209,17284,4,295,1418,3,229,1,66,10.585597,0.003981,,
167.235.145.223,443,162.158.95.216,38648,5,361,1314,3,229,2,132,8.28859,0.003989,,
167.235.145.223,443,162.158.102.137,46330,4,295,2318,3,229,1,66,25.4534,0.028386,64538,18600
167.235.145.223,443,162.158.102.194,59462,4,295,1603,3,229,1,66,13.431362,0.026795,68370,19705
167.235.145.223,443,162.158.103.14,46600,4,295,1241,3,229,1,66,7.438395,0.027691,66158,19067
167.235.145.223,443,162.158.110.9,16952,4,295,2521,3,229,1,66,29.038495,0.004397,,
167.235.145.223,443,162.158.110.77,47412,4,295,2264,3,229,1,66,24.555492,0.004032,,
167.235.145.223,443,162.158.110.103,22506,4,295,2478,3,229,1,66,28.435535,0.00412,,
167.235.145.223,443,162.158.110.150,50410,4,295,2200,3,229,1,66,23.382413,0.004092,,
167.235.145.223,443,162.158.110.176,16226,4,295,2398,3,229,1,66,26.382628,0.004157,,
167.235.145.223,443,162.158.110.177,60848,4,295,1803,3,229,1,66,16.97744,0.004133,,
167.235.145.223,443,162.158.110.177,60844,4,295,2114,3,229,1,66,22.40047,0.004035,,
167.235.145.223,443,162.158.110.178,58306,4,295,2558,3,229,1,66,29.437364,0.004195,,
167.235.145.223,443,162.158.110.197,45290,5,361,1437,3,229,2,132,10.85557,0.00392,,
167.235.145.223,443,162.158.110.199,9522,4,295,1555,3,229,1,66,12.552403,0.003988,,
167.235.145.223,443,162.158.110.220,29384,4,295,1834,3,229,1,66,17.330347,0.004081,,
167.235.145.223,443,162.158.110.232,32276,4,295,1876,3,229,1,66,18.152621,0.00408,,
167.235.145.223,443,162.158.110.242,63774,4,295,2201,3,229,1,66,23.387943,0.004033,,
167.235.145.223,443,162.158.110.254,15114,5,361,1490,3,229,2,132,11.398398,0.004024,,
167.235.145.223,443,162.158.111.14,31372,4,295,1111,3,229,1,66,5.35344,0.004122,,
167.235.145.223,443,162.158.111.19,16952,4,295,2155,3,229,1,66,22.977408,0.004031,,
167.235.145.223,443,162.158.111.159,38838,4,295,325,3,229,1,66,0.550406,0.004082,,
167.235.145.223,443,162.158.111.191,59244,4,295,1894,3,229,1,66,18.586507,0.004081,,
167.235.145.223,443,162.158.111.198,56274,4,295,2007,3,229,1,66,20.05534,0.003938,,
167.235.145.223,443,162.158.111.210,43638,4,295,1049,3,229,1,66,4.951261,0.004062,,
167.235.145.223,443,162.158.129.6,22792,4,295,2504,3,229,1,66,28.757949,0.014853,123342,35548
167.235.145.223,443,162.158.129.39,56904,4,295,1004,3,229,1,66,4.201179,0.020827,87962,25351
167.235.145.223,443,162.158.129.43,46150,4,295,2273,3,229,1,66,24.825454,0.013162,139188,40115
167.235.145.223,443,162.158.129.46,61086,4,295,1729,3,229,1,66,15.514393,0.021194,86439,24912
167.235.145.223,443,162.158.129.46,61072,4,295,1849,3,229,1,66,17.631399,0.023075,79393,22881
167.235.145.223,443,162.158.129.73,12228,4,295,1028,3,229,1,66,4.764439,0.015693,116739,33645
167.235.145.223,443,162.158.129.124,12230,4,295,2565,3,229,1,66,29.640902,0.017866,102541,29553
167.235.145.223,443,162.158.129.148,50052,4,295,2139,3,229,1,66,22.805416,0.017164,106735,30762
167.235.145.223,443,162.158.129.165,14070,4,295,1504,3,229,1,66,11.599416,0.013189,138903,40033
167.235.145.223,443,162.158.129.176,59650,5,361,1551,3,229,2,132,12.476645,0.01794,102118,58862
167.235.145.223,443,162.158.129.186,36724,5,361,984,3,229,2,132,3.824793,0.024034,76225,43937
167.235.145.223,443,162.158.129.194,49644,5,361,2216,3,229,2,132,23.643529,0.021072,86940,50113
167.235.145.223,443,162.158.129.214,39674,4,295,1092,3,229,1,66,5.211727,0.016266,112627,32460
167.235.145.223,443,162.158.129.215,37684,4,295,1113,3,229,1,66,5.371431,0.019513,93886,27058
167.235.145.223,443,162.158.129.245,28278,4,295,1133,3,229,1,66,5.612551,0.015459,118507,34154
167.235.145.223,443,162.158.129.251,18298,5,361,1905,3,229,2,132,18.815425,0.018935,96752,55769
167.235.145.223,443,162.158.129.252,41690,4,295,1435,3,229,1,66,10.825483,0.015168,120780,34810
167.235.145.223,443,162.158.129.252,41674,4,295,1441,3,229,1,66,10.915183,0.021387,85659,24687
167.235.145.223,443,162.158.130.8,47564,4,295,1795,3,229,1,66,16.78586,0.01875,97706,28159
167.235.145.223,443,162.158.130.49,25994,4,295,2173,3,229,1,66,23.129396,0.015336,119457,34428
167.235.145.223,443,162.158.130.49,25996,4,295,2209,3,229,1,66,23.525394,0.021469,85332,24593
167.235.145.223,443,162.158.162.94,31674,4,295,1428,3,229,1,66,10.761506,0.156219,11727,3379
167.235.145.223,443,162.158.162.207,31062,4,295,947,3,229,1,66,3.298408,0.236023,7761,2237
167.235.145.223,443,162.158.163.29,31316,4,295,2123,3,229,1,66,22.601771,0.159519,11484,3309
167.235.145.223,443,162.158.178.72,50538,4,295,1454,3,229,1,66,10.965844,0.190313,9626,2774
167.235.145.223,443,162.158.178.81,30596,4,295,2230,3,229,1,66,24.006488,0.190364,9623,2773
167.235.145.223,443,162.158.178.98,42622,4,295,1069,3,229,1,66,5.043616,0.19062,9610,2769
167.235.145.223,443,162.158.178.156,11364,4,295,2092,3,229,1,66,21.704412,0.188027,9743,2808
167.235.145.223,443,162.158.178.192,41936,4,295,1619,3,229,1,66,13.541358,0.190304,9626,2774
167.235.145.223,443,162.158.179.41,60122,4,295,2010,3,229,1,66,20.117434,0.201032,9112,2626
167.235.145.223,443,162.158.179.143,64152,4,295,2455,3,229,1,66,27.746435,0.182855,10018,2887
167.235.145.223,443,162.158.186.60,14294,4,295,1860,3,229,1,66,17.780779,0.158285,11574,3335
167.235.145.223,443,162.158.186.67,28082,6,427,1141,3,229,3,198,5.76243,0.157817,11608,10036
167.235.145.223,443,162.158.186.159,27976,5,361,1513,3,229,2,132,11.769618,0.156965,11671,6727
167.235.145.223,443,162.158.202.68,17766,4,295,1856,3,229,1,66,17.709525,0.011744,155994,44959
167.235.145.223,443,162.158.202.76,64868,4,295,2222,3,229,1,66,23.727418,0.013949,131335,37852
167.235.145.223,443,162.158.203.101,45936,4,295,1512,3,229,1,66,11.721446,0.011429,160293,46198
167.235.145.223,443,162.158.203.106,56162,5,361,1136,3,229,2,132,5.66445,0.011421,160406,92461
167.235.145.223,443,162.158.222.57,49974,4,295,1177,3,229,1,66,6.499397,0.027015,67814,19544
167.235.145.223,443,162.158.222.68,34000,4,295,305,3,229,1,66,0.508147,0.026628,68799,19828
167.235.145.223,443,162.158.222.88,28358,5,361,1727,3,229,2,132,15.449956,0.026677,68673,39584
167.235.145.223,443,162.158.222.94,53300,4,295,2445,3,229,1,66,27.454483,0.026656,68727,19807
167.235.145.223,443,162.158.222.136,28966,4,295,1374,3,229,1,66,9.443473,0.027076,67661,19500
167.235.145.223,443,162.158.222.144,49002,4,295,2078,3,229,1,66,21.350446,0.026815,68319,19690
167.235.145.223,443,162.158.222.150,20096,5,361,2258,3,229,2,132,24.501463,0.026795,68370,39410
167.235.145.223,443,162.158.222.247,39536,4,295,958,3,229,1,66,3.437476,0.026812,68327,19692
167.235.145.223,443,172.68.50.5,50248,4,295,721,3,229,1,66,1.573413,0.012666,144639,41686
167.235.145.223,443,172.68.50.67,40312,4,295,2144,3,229,1,66,22.87442,0.012047,152071,43828
167.235.145.223,443,172.68.50.144,29680,4,295,2460,3,229,1,66,27.921523,0.012048,152058,43824
167.235.145.223,443,172.68.51.10,30996,5,361,1261,3,229,2,132,7.678406,0.012633,145017,83590
167.235.145.223,443,172.68.51.21,40272,4,295,2177,3,229,1,66,23.161448,0.012034,152235,43875
167.235.145.223,443,172.68.51.29,47386,4,295,1817,3,229,1,66,17.167292,0.012725,143968,41493
167.235.145.223,443,172.68.51.30,25376,4,295,1955,3,229,1,66,19.56084,0.012016,152463,43941
167.235.145.223,443,172.68.51.73,42176,4,295,2364,3,229,1,66,25.893885,0.01197,153049,44110
167.235.145.223,443,172.68.51.74,28880,4,295,2150,3,229,1,66,22.941468,0.012053,151995,43806
167.235.145.223,443,172.68.51.80,12288,4,295,1353,3,229,1,66,8.896503,0.012155,150719,43438
167.235.145.223,443,172.68.51.108,61440,4,295,1522,3,229,1,66,11.923468,0.01332,137537,39639
167.235.145.223,443,172.68.51.150,37816,4,295,2110,3,229,1,66,22.291444,0.012123,151117,43553
167.235.145.223,443,172.68.51.151,19530,4,295,2530,3,229,1,66,29.182513,0.012038,152184,43861
167.235.145.223,443,172.68.51.209,65446,4,295,1038,3,229,1,66,4.89546,0.011993,152755,44025
167.235.145.223,443,172.68.62.37,50862,4,295,2370,3,229,1,66,25.97667,0.053792,34057,9815
167.235.145.223,443,172.68.62.58,32014,4,295,901,3,229,1,66,2.648394,0.056818,32243,9292
167.235.145.223,443,172.68.62.70,47396,4,295,2420,3,229,1,66,26.883546,0.056609,32362,9327
167.235.145.223,443,172.68.62.93,59948,4,295,1334,3,229,1,66,8.524397,0.050873,36011,10378
167.235.145.223,443,172.68.62.108,45094,4,295,1998,3,229,1,66,19.967684,0.056782,32263,9298
167.235.145.223,443,172.68.62.153,35492,4,295,1691,3,229,1,66,14.575411,0.04765,38447,11080
167.235.145.223,443,172.68.62.196,46352,4,295,778,3,229,1,66,1.794421,0.050253,36455,10506
167.235.145.223,443,172.68.62.210,17920,4,295,1291,3,229,1,66,7.968382,0.050303,36419,10496
167.235.145.223,443,172.68.62.213,9334,5,361,1807,3,229,2,132,17.043474,0.050346,36388,20974
167.235.145.223,443,172.68.62.223,33906,4,295,1656,3,229,1,66,13.955496,0.050004,36637,10559
167.235.145.223,443,172.68.110.13,24576,4,295,2251,3,229,1,66,24.385436,0.00633,289415,83412
167.235.145.223,443,172.68.110.122,34208,4,295,1356,3,229,1,66,8.906448,0.00636,288050,83018
167.235.145.223,443,172.68.110.139,44098,5,361,812,3,229,2,132,1.956407,0.006459,283635,163492
167.235.145.223,443,172.68.110.140,17516,4,295,1651,3,229,1,66,13.877425,0.006556,279438,80536
167.235.145.223,443,172.68.110.158,24336,4,295,2336,3,229,1,66,25.657425,0.006411,285758,82358
167.235.145.223,443,172.68.110.161,61832,4,295,1037,3,229,1,66,4.86545,0.006889,265931,76643
167.235.145.223,443,172.68.110.179,11034,4,295,794,3,229,1,66,1.875404,0.006456,283767,81784
167.235.145.223,443,172.68.110.196,17528,4,295,1978,3,229,1,66,19.748583,0.006429,284958,82127
167.235.145.223,443,172.68.130.138,49302,4,295,2065,3,229,1,66,20.991405,0.056867,32215,9284
167.235.145.223,443,172.68.138.17,43438,4,295,1946,3,229,1,66,19.446646,0.028951,63279,18237
167.235.145.223,443,172.68.139.37,27924,4,295,681,3,229,1,66,1.434431,0.028107,65179,18785
167.235.145.223,443,172.69.43.137,10750,4,295,2328,3,229,1,66,25.586391,0.02049,89409,25768
167.235.145.223,443,172.69.64.219,51102,6,427,1169,3,229,3,198,6.210602,0.135254,13544,11711
167.235.145.223,443,172.69.65.94,38818,5,361,1885,3,229,2,132,18.235372,0.134172,13654,7870
167.235.145.223,443,172.69.65.147,9772,1006,4352895,5,511,4318425,495,34470,0.002708,65.940939,523914,4181
167.235.145.223,443,172.69.67.153,57348,5,361,2245,3,229,2,132,24.299483,0.136674,13404,7726
167.235.145.223,443,172.69.67.159,59702,5,361,1546,3,229,2,132,12.313785,0.134861,13584,7830
167.235.145.223,443,172.69.67.169,25610,5,361,116,3,229,2,132,0.189417,0.130981,13986,8062
167.235.145.223,443,172.69.70.41,37104,4,295,2042,3,229,1,66,20.598419,0.113127,16194,4667
167.235.145.223,443,172.69.70.158,45272,5,361,1871,3,229,2,132,17.999383,0.112991,16213,9345
167.235.145.223,443,172.69.71.75,27164,4,295,1938,3,229,1,66,19.306404,0.113094,16198,4668
167.235.145.223,443,172.69.71.104,49726,5,361,2118,3,229,2,132,22.521517,0.113041,16206,9341
167.235.145.223,443,172.69.71.114,54728,5,361,1776,3,229,2,132,16.537485,0.113174,16187,9330
167.235.145.223,443,172.69.71.211,64232,5,361,2486,3,229,2,132,28.519372,0.112903,16226,9353
167.235.145.223,443,172.69.79.133,27622,5,361,51,3,229,2,132,0.078414,0.020465,89518,51600
167.235.145.223,443,172.69.79.172,31918,4,295,1598,3,229,1,66,13.361407,0.020335,90090,25965
167.235.145.223,443,172.69.79.183,26998,5,361,1702,3,229,2,132,14.742502,0.038062,48131,27744
167.235.145.223,443,172.69.150.23,38650,4,295,904,3,229,1,66,2.667484,0.003983,,
167.235.145.223,443,172.69.150.81,56390,4,295,1793,3,229,1,66,16.747734,0.004098,,
167.235.145.223,443,172.69.150.81,56372,5,361,1821,3,229,2,132,17.208892,0.004523,,
167.235.145.223,443,172.69.150.96,39392,4,295,1340,3,229,1,66,8.661448,0.004629,,
167.235.145.223,443,172.69.150.138,54754,4,295,2360,3,229,1,66,25.862414,0.004208,,
167.235.145.223,443,172.69.150.153,48560,4,295,1696,3,229,1,66,14.661457,0.004007,,
167.235.145.223,443,172.69.150.175,58746,5,361,2129,3,229,2,132,22.709101,0.003965,,
167.235.145.223,443,172.69.150.175,58752,4,295,2175,3,229,1,66,23.138154,0.004668,,
167.235.145.223,443,172.69.150.177,20380,4,295,2555,3,229,1,66,29.423535,0.003951,,
167.235.145.223,443,172.69.151.22,19814,5,361,1649,3,229,2,132,13.872887,0.003968,,
167.235.145.223,443,172.69.151.35,63668,4,295,1895,3,229,1,66,18.630459,0.00423,,
167.235.145.223,443,172.69.151.43,60684,4,295,2413,3,229,1,66,26.664895,0.003974,,
167.235.145.223,443,172.69.151.74,19002,4,295,795,3,229,1,66,1.881381,0.004095,,
167.235.145.223,443,172.69.165.18,47062,4,295,2357,3,229,1,66,25.853353,0.168047,10901,3141
167.235.145.223,443,172.69.194.26,9472,4,295,2260,3,229,1,66,24.504233,0.022877,80080,23079
167.235.145.223,443,172.69.194.39,32712,4,295,1958,3,229,1,66,19.58748,0.023418,78230,22546
167.235.145.223,443,172.69.194.46,9332,4,295,1809,3,229,1,66,17.057211,0.021678,84509,24356
167.235.145.223,443,172.69.194.134,54774,4,295,731,3,229,1,66,1.59584,0.020592,88966,25641
167.235.145.223,443,172.69.194.160,42266,4,295,2299,3,229,1,66,25.194373,0.021253,86199,24843
167.235.145.223,443,172.69.194.221,11236,4,295,1197,3,229,1,66,6.79938,0.020345,90046,25952
167.235.145.223,443,172.69.195.37,15836,4,295,1845,3,229,1,66,17.587402,0.022117,82832,23873
167.235.145.223,443,172.69.195.37,15852,4,295,1851,3,229,1,66,17.636077,0.021606,84791,24437
167.235.145.223,443,172.69.195.63,22424,4,295,1925,3,229,1,66,19.165421,0.022019,83200,23979
167.235.145.223,443,172.69.195.94,26446,5,361,959,3,229,2,132,3.448373,0.022017,83208,47962
167.235.145.223,443,172.69.195.141,40376,4,295,319,3,229,1,66,0.537445,0.021386,85663,24689
167.235.145.223,443,172.69.195.178,18978,5,361,1624,3,229,2,132,13.589481,0.020316,90175,51978
167.235.145.223,443,172.69.195.230,27214,5,361,1254,3,229,2,132,7.617557,0.02228,82226,47396
167.235.145.223,443,172.69.222.14,17052,5,361,1211,3,229,2,132,7.051447,0.015269,119981,69159
167.235.145.223,443,172.69.222.36,39904,5,361,1307,3,229,2,132,8.177531,0.012898,142037,81873
167.235.145.223,443,172.69.222.57,52838,4,295,2405,3,229,1,66,26.50471,0.015291,119809,34530
167.235.145.223,443,172.69.222.79,11078,5,361,1880,3,229,2,132,18.181458,0.015112,121228,69878
167.235.145.223,443,172.69.222.109,11518,4,295,920,3,229,1,66,2.845797,0.015508,118132,34046
167.235.145.223,443,172.69.222.134,51364,5,361,742,3,229,2,132,1.632386,0.015389,119046,68620
167.235.145.223,443,172.69.222.150,54182,4,295,1648,3,229,1,66,13.854412,0.015111,121236,34941
167.235.145.223,443,172.69.222.155,64826,4,295,1536,3,229,1,66,12.188433,0.012775,143405,41330
167.235.145.223,443,172.69.222.161,12984,4,295,2202,3,229,1,66,23.463357,0.01297,141249,40709
167.235.145.223,443,172.69.222.171,22128,4,295,1933,3,229,1,66,19.27074,0.015347,119371,34404
167.235.145.223,443,172.69.222.200,44388,4,295,1453,3,229,1,66,10.965399,0.015121,121156,34918
167.235.145.223,443,172.69.222.201,46666,4,295,1476,3,229,1,66,11.177394,0.016219,112953,32554
167.235.145.223,443,172.69.222.212,49200,4,295,1806,3,229,1,66,17.021326,0.014499,126353,36416
167.235.145.223,443,172.69.222.213,29448,4,295,1829,3,229,1,66,17.260699,0.012791,143225,41279
167.235.145.223,443,172.69.222.252,45712,4,295,2009,3,229,1,66,20.116378,0.015037,121832,35113
167.235.145.223,443,172.69.223.29,44590,4,295,725,3,229,1,66,1.581412,0.012509,146454,42209
167.235.145.223,443,172.69.223.56,41630,4,295,1305,3,229,1,66,8.142608,0.014401,127213,36664
167.235.145.223,443,172.69.223.61,23622,4,295,2569,3,229,1,66,29.687476,0.014416,127081,36625
167.235.145.223,443,172.69.223.74,26676,4,295,2239,3,229,1,66,24.203363,0.012834,142745,41140
167.235.145.223,443,172.69.223.139,25226,4,295,2365,3,229,1,66,25.920455,0.014352,127647,36789
167.235.145.223,443,172.69.223.186,55246,4,295,1228,3,229,1,66,7.301326,0.012307,148858,42902
167.235.145.223,443,172.70.34.70,15354,5,361,2421,3,229,2,132,26.901967,0.101657,18021,10387
167.235.145.223,443,172.70.34.117,34994,4,295,1710,3,229,1,66,14.941438,0.102325,17903,5160
167.235.145.223,443,172.70.34.131,42784,4,295,1365,3,229,1,66,9.096443,0.099893,18339,5285
167.235.145.223,443,172.70.34.139,13880,4,295,2066,3,229,1,66,21.004488,0.10192,17974,5180
167.235.145.223,443,172.70.35.72,39620,4,295,928,3,229,1,66,2.935434,0.099939,18331,5283
167.235.145.223,443,172.70.46.32,35786,4,295,1375,3,229,1,66,9.458626,0.009517,192497,55479
167.235.145.223,443,172.70.46.34,11600,4,295,2338,3,229,1,66,25.667433,0.009552,191792,55276
167.235.145.223,443,172.70.46.78,56746,4,295,1986,3,229,1,66,19.818497,0.009584,191151,55091
167.235.145.223,443,172.70.46.102,15012,4,295,1219,3,229,1,66,7.141529,0.009471,193432,55749
167.235.145.223,443,172.70.46.107,27388,4,295,2027,3,229,1,66,20.312421,0.009446,193944,55896
167.235.145.223,443,172.70.46.150,19968,4,295,1440,3,229,1,66,10.901509,0.009481,193228,55690
167.235.145.223,443,172.70.46.157,61326,4,295,1725,3,229,1,66,15.440476,0.009497,192903,55596
167.235.145.223,443,172.70.46.171,15580,4,295,734,3,229,1,66,1.599637,0.009567,191491,55189
167.235.145.223,443,172.70.46.178,46646,4,295,1140,3,229,1,66,5.741477,0.009708,188710,54388
167.235.145.223,443,172.70.47.3,59846,4,295,2520,3,229,1,66,28.984396,0.009381,195288,56283
167.235.145.223,443,172.70.47.3,59842,4,295,2522,3,229,1,66,29.040368,0.009511,192619,55514
167.235.145.223,443,172.70.47.6,14946,4,295,822,3,229,1,66,2.016425,0.009508,192679,55532
167.235.145.223,443,172.70.47.10,41344,4,295,964,3,229,1,66,3.560001,0.009436,194150,55955
167.235.145.223,443,172.70.85.25,23006,4,295,1542,3,229,1,66,12.266279,0.021392,85639,24682
167.235.145.223,443,172.70.85.36,43872,4,295,148,3,229,1,66,0.239571,0.020376,89909,25912
167.235.145.223,443,172.70.85.94,13502,5,361,2194,3,229,2,132,23.305725,0.021588,84861,48916
167.235.145.223,443,172.70.85.236,37430,4,295,2244,3,229,1,66,24.266567,0.022098,82903,23893
167.235.145.223,443,172.70.86.93,11468,4,295,1439,3,229,1,66,10.888432,0.020256,90442,26066
167.235.145.223,443,172.70.86.125,20282,4,295,1887,3,229,1,66,18.289475,0.021235,86272,24864
167.235.145.223,443,172.70.86.154,49296,4,295,1831,3,229,1,66,17.279388,0.021483,85276,24577
167.235.145.223,443,172.70.86.195,58496,5,361,1103,3,229,2,132,5.296399,0.021442,85439,49249
167.235.145.223,443,172.70.90.36,35176,4,295,1952,3,229,1,66,19.530356,0.021147,86631,24968
167.235.145.223,443,172.70.90.119,62940,4,295,2322,3,229,1,66,25.53176,0.021405,85587,24667
167.235.145.223,443,172.70.90.130,59860,4,295,987,3,229,1,66,3.865398,0.021315,85948,24771
167.235.145.223,443,172.70.90.204,47022,4,295,2099,3,229,1,66,21.85536,0.021007,87209,25134
167.235.145.223,443,172.70.90.231,62866,4,295,2456,3,229,1,66,27.867477,0.021876,83744,24136
167.235.145.223,443,172.70.91.18,11200,4,295,706,3,229,1,66,1.523344,0.020397,89817,25886
167.235.145.223,443,172.70.91.97,46804,4,295,1247,3,229,1,66,7.530378,0.020352,90015,25943
167.235.145.223,443,172.70.91.198,38598,5,361,1742,3,229,2,132,15.862788,0.021176,86513,49867
167.235.145.223,443,172.70.92.200,17994,4,295,1209,3,229,1,66,6.992657,0.169498,10808,3115
167.235.145.223,443,172.70.93.3,14232,4,295,2288,3,229,1,66,24.981441,0.161076,11373,3277
167.235.145.223,443,172.70.93.9,31588,4,295,1944,3,229,1,66,19.435408,0.219178,8358,2409
167.235.145.223,443,172.70.93.10,46218,4,295,1234,3,229,1,66,7.36846,0.154375,11867,3420
167.235.145.223,443,172.70.147.17,64472,5,361,2283,3,229,2,132,24.916399,0.169104,10833,6244
167.235.145.223,443,172.70.147.97,15216,4,295,524,3,229,1,66,0.970444,0.160528,11412,3289
167.235.145.223,443,172.70.147.182,41436,4,295,1576,3,229,1,66,12.964371,0.16368,11192,3225
167.235.145.223,443,172.70.147.190,34998,4,295,643,3,229,1,66,1.300435,0.154541,11854,3416
167.235.145.223,443,172.70.147.200,43830,4,295,1596,3,229,1,66,13.355724,0.168382,10880,3135
167.235.145.223,443,172.70.210.17,44306,5,361,980,3,229,2,132,3.736442,0.157348,11642,6711
167.235.145.223,443,172.70.210.116,31692,4,295,1737,3,229,1,66,15.763415,0.162093,11302,3257
167.235.145.223,443,172.70.211.92,50112,4,295,2452,3,229,1,66,27.733489,0.156574,11700,3372
167.235.145.223,443,172.70.211.116,56238,4,295,1389,3,229,1,66,9.761463,0.158657,11546,3327
167.235.145.223,443,172.70.211.214,51774,4,295,2096,3,229,1,66,21.777414,0.161875,11317,3261
167.235.145.223,443,172.70.242.11,47306,4,295,2085,3,229,1,66,21.44699,0.004074,,
167.235.145.223,443,172.70.242.79,64470,4,295,2462,3,229,1,66,27.940443,0.004083,,
167.235.145.223,443,172.70.242.80,27124,4,295,1377,3,229,1,66,9.53139,0.003997,,
167.235.145.223,443,172.70.242.87,22020,4,295,1897,3,229,1,66,18.635393,0.004052,,
167.235.145.223,443,172.70.242.96,31178,5,361,948,3,229,2,132,3.318448,0.003901,,
167.235.145.223,443,172.70.242.98,43144,4,295,1720,3,229,1,66,15.363413,0.004106,,
167.235.145.223,443,172.70.242.151,33272,5,361,2094,3,229,2,132,21.741385,0.004004,,
167.235.145.223,443,172.70.242.158,29974,4,295,1054,3,229,1,66,4.982445,0.004901,,
167.235.145.223,443,172.70.242.174,16500,4,295,2518,3,229,1,66,28.951521,0.003995,,
167.235.145.223,443,172.70.242.241,65394,4,295,973,3,229,1,66,3.64239,0.004089,,
167.235.145.223,443,172.70.243.32,48624,4,295,1402,3,229,1,66,10.181484,0.00462,,
167.235.145.223,443,172.70.243.177,48784,4,295,1548,3,229,1,66,12.386002,0.004027,,
167.235.145.223,443,172.70.243.215,50306,5,361,963,3,229,2,132,3.558491,0.003903,,
167.235.145.223,443,172.70.246.20,31932,4,295,2439,3,229,1,66,27.238656,0.004033,,
167.235.145.223,443,172.70.246.68,14138,4,295,1417,3,229,1,66,10.579481,0.004158,,
167.235.145.223,443,172.70.246.72,16878,4,295,1917,3,229,1,66,18.982373,0.004324,,
167.235.145.223,443,172.70.246.197,60038,4,295,2418,3,229,1,66,26.841384,0.00401,,
167.235.145.223,443,172.70.246.201,55290,4,295,933,3,229,1,66,3.081437,0.004025,,
167.235.145.223,443,172.70.246.208,17312,4,295,1714,3,229,1,66,15.160904,0.003941,,
167.235.145.223,443,172.70.246.212,45664,4,295,1349,3,229,1,66,8.841832,0.00402,,
167.235.145.223,443,172.70.246.253,35876,4,295,918,3,229,1,66,2.828514,0.003885,,
167.235.145.223,443,172.70.247.50,50188,4,295,1207,3,229,1,66,6.959433,0.004017,,
167.235.145.223,443,172.70.247.99,24858,5,361,1364,3,229,2,132,9.079544,0.004065,,
167.235.145.223,443,172.70.247.177,62646,4,295,1705,3,229,1,66,14.854479,0.003975,,
167.235.145.223,443,172.70.247.197,58124,4,295,520,3,229,1,66,0.963413,0.004013,,
167.235.145.223,443,172.70.250.41,28506,4,295,465,3,229,1,66,0.825432,0.004017,,
167.235.145.223,443,172.70.250.128,64374,5,361,2070,3,229,2,132,21.134662,0.004036,,
167.235.145.223,443,172.70.250.139,46424,4,295,1501,3,229,1,66,11.564486,0.004008,,
167.235.145.223,443,172.70.250.146,9970,4,295,2464,3,229,1,66,28.014555,0.00411,,
167.235.145.223,443,172.70.250.181,37118,4,295,1848,3,229,1,66,17.606957,0.004085,,
167.235.145.223,443,172.70.250.219,15128,4,295,2217,3,229,1,66,23.649429,0.004053,,
167.235.145.223,443,172.70.250.237,15760,4,295,2274,3,229,1,66,24.832645,0.004076,,
167.235.145.223,443,172.70.251.40,10170,4,295,1791,3,229,1,66,16.735567,0.004098,,
167.235.145.223,443,172.70.251.52,39816,4,295,2579,3,229,1,66,29.900647,0.004195,,
167.235.145.223,443,172.70.251.64,62360,4,295,2541,3,229,1,66,29.230715,0.004106,,
167.235.145.223,443,172.70.251.119,32620,4,295,1713,3,229,1,66,15.153273,0.003982,,
167.235.145.223,443,172.70.251.124,38474,4,295,1203,3,229,1,66,6.838377,0.004166,,
167.235.145.223,443,172.70.251.205,48914,4,295,972,3,229,1,66,3.637413,0.004039,,
167.235.145.223,443,172.70.251.219,53232,5,361,937,3,229,2,132,3.128513,0.004131,,
167.235.145.223,443,172.71.94.48,41972,4,295,1523,3,229,1,66,11.937473,0.009578,191271,55126
167.235.145.223,443,172.71.94.51,54336,4,295,2272,3,229,1,66,24.752417,0.00958,191231,55114
167.235.145.223,443,172.71.94.52,35840,4,295,1700,3,229,1,66,14.725701,0.009557,191691,55247
167.235.145.223,443,172.71.94.83,46024,4,295,2193,3,229,1,66,23.29637,0.00954,192033,55345
167.235.145.223,443,172.71.94.83,46012,4,295,2425,3,229,1,66,26.986534,0.009513,192578,55502
167.235.145.223,443,172.71.94.87,45336,4,295,1122,3,229,1,66,5.4384,0.009634,190159,54805
167.235.145.223,443,172.71.94.93,9568,4,295,1104,3,229,1,66,5.306477,0.009564,191551,55207
167.235.145.223,443,172.71.94.93,9566,4,295,1361,3,229,1,66,8.996428,0.009522,192396,55450
167.235.145.223,443,172.71.94.122,59380,4,295,1820,3,229,1,66,17.199448,0.009658,189687,54669
167.235.145.223,443,172.71.94.146,34252,4,295,2304,3,229,1,66,25.260544,0.009457,193718,55831
167.235.145.223,443,172.71.94.196,42174,4,295,2250,3,229,1,66,24.334459,0.009647,189903,54732
167.235.145.223,443,172.71.94.201,18518,4,295,2165,3,229,1,66,23.07238,0.00946,193657,55813
167.235.145.223,443,172.71.94.215,41818,5,361,1154,3,229,2,132,6.084514,0.009751,187878,108296
167.235.145.223,443,172.71.94.228,19934,4,295,1126,3,229,1,66,5.47944,0.009584,191151,55091
167.235.145.223,443,172.71.94.252,27328,4,295,1827,3,229,1,66,17.259526,0.009601,190813,54994
167.235.145.223,443,172.71.94.252,27320,4,295,2064,3,229,1,66,20.987478,0.009672,189412,54590
167.235.145.223,443,172.71.98.36,48722,4,295,1643,3,229,1,66,13.765357,0.009641,190021,54766
167.235.145.223,443,172.71.98.42,48178,4,295,2346,3,229,1,66,25.764568,0.009471,193432,55749
167.235.145.223,443,172.71.98.90,51440,5,361,1526,3,229,2,132,12.067035,0.009367,195580,112736
167.235.145.223,443,172.71.98.134,19004,4,295,1164,3,229,1,66,6.174396,0.009489,193065,55643
167.235.145.223,443,172.71.98.172,58538,4,295,1224,3,229,1,66,7.260761,0.009525,192335,55433
167.235.145.223,443,172.71.98.232,45138,4,295,989,3,229,1,66,3.920498,0.00964,190041,54771
167.235.145.223,443,172.71.98.247,37670,4,295,1936,3,229,1,66,19.289372,0.009708,188710,54388
167.235.145.223,443,172.71.99.22,64034,4,295,1869,3,229,1,66,17.947494,0.009503,192781,55561
167.235.145.223,443,172.71.99.40,59574,4,295,1623,3,229,1,66,13.578446,0.009692,189021,54477
167.235.145.223,443,172.71.99.145,52136,4,295,621,3,229,1,66,1.240403,0.009421,194459,56045
167.235.145.223,443,172.71.99.196,58306,4,295,2226,3,229,1,66,23.833457,0.009622,190397,54874
167.235.145.223,443,172.71.99.200,14566,4,295,1968,3,229,1,66,19.688337,0.009547,191892,55305
167.235.145.223,443,172.71.99.235,33404,4,295,755,3,229,1,66,1.687368,0.009536,192114,55369
167.235.145.223,443,172.71.102.24,53114,4,295,2371,3,229,1,66,25.979416,0.009622,190397,54874
167.235.145.223,443,172.71.102.46,37514,4,295,2549,3,229,1,66,29.270451,0.009452,193821,55861
167.235.145.223,443,172.71.102.80,18072,4,295,1830,3,229,1,66,17.268495,0.009737,188148,54226
167.235.145.223,443,172.71.102.94,52406,4,295,1394,3,229,1,66,9.931498,0.009509,192659,55526
167.235.145.223,443,172.71.102.131,46524,4,295,2191,3,229,1,66,23.284777,0.00942,194479,56050
167.235.145.223,443,172.71.102.149,11594,4,295,1483,3,229,1,66,11.287453,0.009496,192923,55602
167.235.145.223,443,172.71.102.199,25248,4,295,1056,3,229,1,66,4.986488,0.009879,185443,53446
167.235.145.223,443,172.71.102.211,32132,4,295,2076,3,229,1,66,21.271036,0.009949,184139,53070
167.235.145.223,443,172.71.102.212,42790,4,295,1433,3,229,1,66,10.788474,0.016804,109021,31421
167.235.145.223,443,172.71.102.254,23544,4,295,1960,3,229,1,66,19.607361,0.00956,191631,55230
167.235.145.223,443,172.71.103.53,32964,4,295,806,3,229,1,66,1.935569,0.01031,177691,51212
167.235.145.223,443,172.71.103.84,12926,4,295,1604,3,229,1,66,13.43384,0.00943,194273,55991
167.235.145.223,443,172.71.103.84,12932,5,361,1617,3,229,2,132,13.536745,0.009517,192497,110959
167.235.145.223,443,172.71.103.92,43762,4,295,2461,3,229,1,66,27.935433,0.009461,193637,55808
167.235.145.223,443,172.71.103.123,42500,4,295,2534,3,229,1,66,29.195477,0.009661,189628,54652
167.235.145.223,443,172.71.103.127,39754,4,295,2167,3,229,1,66,23.107465,0.009856,185876,53571
167.235.145.223,443,172.71.103.128,31052,5,361,2147,3,229,2,132,22.927765,0.009542,191993,110668
167.235.145.223,443,172.71.103.162,35678,5,361,1637,3,229,2,132,13.711526,0.010226,179151,103266
167.235.145.223,443,172.71.103.228,11694,4,295,930,3,229,1,66,3.053372,0.00957,191431,55172
167.235.145.223,443,172.71.103.230,24338,4,295,2101,3,229,1,66,21.923387,0.009385,195205,56259
167.235.145.223,443,172.71.114.2,51990,4,295,867,3,229,1,66,2.294423,0.021418,85535,24652
167.235.145.223,443,172.71.114.16,20906,4,295,1238,3,229,1,66,7.411408,0.014817,123641,35634
167.235.145.223,443,172.71.114.31,37570,4,295,1915,3,229,1,66,18.954547,0.021903,83641,24106
167.235.145.223,443,172.71.114.46,11442,4,295,2061,3,229,1,66,20.915412,0.013018,140728,40559
167.235.145.223,443,172.71.114.67,19682,4,295,570,3,229,1,66,1.069459,0.014567,125763,36246
167.235.145.223,443,172.71.114.70,17258,4,295,2298,3,229,1,66,25.186464,0.021409,85571,24662
167.235.145.223,443,172.71.114.71,21864,4,295,2291,3,229,1,66,25.07666,0.012991,141020,40643
167.235.145.223,443,172.71.114.99,63492,4,295,1582,3,229,1,66,13.097533,0.018432,99392,28645
167.235.145.223,443,172.71.114.108,38144,4,295,2544,3,229,1,66,29.251533,0.013735,133381,38441
167.235.145.223,443,172.71.114.108,38156,4,295,2551,3,229,1,66,29.347518,0.013893,131864,38004
167.235.145.223,443,172.71.114.117,44134,4,295,1208,3,229,1,66,6.966434,0.015097,121348,34973
167.235.145.223,443,172.71.114.148,26836,4,295,2392,3,229,1,66,26.310933,0.014364,127541,36758
167.235.145.223,443,172.71.114.157,27846,4,295,1317,3,229,1,66,8.317589,0.013738,133352,38433
167.235.145.223,443,172.71.114.222,12632,5,361,1215,3,229,2,132,7.107532,0.018296,100131,57717
167.235.145.223,443,172.71.115.32,44336,4,295,1565,3,229,1,66,12.691472,0.021515,85149,24541
167.235.145.223,443,172.71.115.63,10044,4,295,1586,3,229,1,66,13.171859,0.01483,123533,35603
167.235.145.223,443,172.71.115.64,54124,4,295,1580,3,229,1,66,13.064367,0.018399,99570,28697
167.235.145.223,443,172.71.122.8,23530,4,295,840,3,229,1,66,2.149412,0.012857,142490,41067
167.235.145.223,443,172.71.122.27,10164,4,295,1538,3,229,1,66,12.212938,0.015147,120948,34858
167.235.145.223,443,172.71.122.82,40218,4,295,1857,3,229,1,66,17.740643,0.015237,120233,34652
167.235.145.223,443,172.71.122.128,24280,4,295,708,3,229,1,66,1.525416,0.015445,118614,34185
167.235.145.223,443,172.71.122.181,49400,4,295,2354,3,229,1,66,25.839407,0.015302,119722,34505
167.235.145.223,443,172.71.122.205,56016,4,295,1491,3,229,1,66,11.398452,0.015393,119015,34301
167.235.145.223,443,172.71.122.246,15284,4,295,528,3,229,1,66,0.981756,0.012986,141075,40659
167.235.145.223,443,172.71.123.5,53784,4,295,1114,3,229,1,66,5.382452,0.013031,140587,40518
167.235.145.223,443,172.71.123.109,22944,5,361,2218,3,229,2,132,23.680592,0.012501,146548,84473
167.235.145.223,443,172.71.123.144,31824,4,295,1883,3,229,1,66,18.206884,0.012194,150237,43299
167.235.145.223,443,172.71.123.158,11404,4,295,1674,3,229,1,66,14.129432,0.01239,147861,42615
167.235.145.223,443,172.71.130.18,40344,4,295,2210,3,229,1,66,23.543642,0.012207,150077,43253
167.235.145.223,443,172.71.130.36,60388,4,295,1560,3,229,1,66,12.635585,0.012257,149465,43077
167.235.145.223,443,172.71.130.41,15030,4,295,2269,3,229,1,66,24.691442,0.012429,147397,42481
167.235.145.223,443,172.71.130.93,52004,4,295,1564,3,229,1,66,12.688003,0.012513,146407,42196
167.235.145.223,443,172.71.130.158,47194,5,361,1903,3,229,2,132,18.714637,0.014835,123491,71183
167.235.145.223,443,172.71.130.169,22544,4,295,1196,3,229,1,66,6.789385,0.014617,125333,36122
167.235.145.223,443,172.71.130.170,25054,5,361,2528,3,229,2,132,29.172518,0.012189,150299,86635
167.235.145.223,443,172.71.130.186,30734,4,295,374,3,229,1,66,0.649458,0.014587,125591,36196
167.235.145.223,443,172.71.131.7,11444,4,295,1572,3,229,1,66,12.862417,0.01465,125051,36040
167.235.145.223,443,172.71.131.38,56062,4,295,1847,3,229,1,66,17.60547,0.012221,149905,43204
167.235.145.223,443,172.71.131.47,59848,4,295,1186,3,229,1,66,6.629368,0.012304,148894,42912
167.235.145.223,443,172.71.131.50,11424,4,295,736,3,229,1,66,1.615444,0.012408,147646,42553
167.235.145.223,443,172.71.131.55,60936,4,295,593,3,229,1,66,1.129391,0.014434,126922,36580
167.235.145.223,443,172.71.131.109,58444,4,295,392,3,229,1,66,0.683605,0.012316,148749,42871
167.235.145.223,443,172.71.131.177,26594,4,295,2467,3,229,1,66,28.094476,0.012499,146571,42243
167.235.145.223,443,172.71.131.187,38718,4,295,807,3,229,1,66,1.937352,0.012398,147765,42587
167.235.145.223,443,172.71.134.48,28696,4,295,2403,3,229,1,66,26.473399,0.011994,152743,44022
167.235.145.223,443,172.71.134.85,21698,5,361,1346,3,229,2,132,8.793742,0.01431,128022,73794
167.235.145.223,443,172.71.134.116,34944,4,295,224,3,229,1,66,0.367415,0.012073,151743,43733
167.235.145.223,443,172.71.134.124,21558,4,295,2037,3,229,1,66,20.561449,0.01213,151030,43528
167.235.145.223,443,172.71.134.142,45984,4,295,1685,3,229,1,66,14.446437,0.011899,153962,44373
167.235.145.223,443,172.71.134.173,38084,4,295,2404,3,229,1,66,26.502464,0.011828,154886,44639
167.235.145.223,443,172.71.134.246,57294,4,295,878,3,229,1,66,2.446368,0.011752,155888,44928
167.235.145.223,443,172.71.135.12,38606,5,361,2252,3,229,2,132,24.432454,0.01207,151781,87489
167.235.145.223,443,172.71.135.39,41200,4,295,1499,3,229,1,66,11.514443,0.012396,147789,42594
167.235.145.223,443,172.71.135.95,10028,4,295,1332,3,229,1,66,8.484464,0.014812,123683,35646
167.235.145.223,443,172.71.135.100,52544,4,295,2030,3,229,1,66,20.460432,0.012194,150237,43299
167.235.145.223,443,172.71.135.114,43060,4,295,897,3,229,1,66,2.614544,0.01437,127487,36743
167.235.145.223,443,172.71.160.23,25368,4,295,1297,3,229,1,66,8.022359,0.013521,135492,39050
167.235.145.223,443,172.71.182.70,50504,4,295,2408,3,229,1,66,26.545379,0.009365,195621,56380
167.235.145.223,443,172.71.182.87,32196,4,295,1574,3,229,1,66,12.873452,0.009758,187743,54109
167.235.145.223,443,172.71.182.93,20882,4,295,1498,3,229,1,66,11.506439,0.009515,192538,55491
167.235.145.223,443,172.71.182.146,61006,4,295,2278,3,229,1,66,24.866097,0.009539,192053,55351
167.235.145.223,443,172.71.182.151,62806,4,295,2184,3,229,1,66,23.215381,0.009499,192862,55584
167.235.145.223,443,172.71.182.156,49722,4,295,2574,3,229,1,66,29.825392,0.009498,192882,55590
167.235.145.223,443,172.71.182.163,22604,4,295,888,3,229,1,66,2.535388,0.009547,191892,55305
167.235.145.223,443,172.71.182.178,20996,4,295,1802,3,229,1,66,16.95547,0.009493,192984,55619
167.235.145.223,443,172.71.182.190,48480,4,295,2052,3,229,1,66,20.737456,0.0095,192842,55578
167.235.145.223,443,172.71.182.197,61596,4,295,1205,3,229,1,66,6.913565,0.009463,193596,55796
167.235.145.223,443,172.71.182.219,11696,4,295,1457,3,229,1,66,10.997617,0.009549,191852,55293
167.235.145.223,443,172.71.182.222,57908,4,295,1073,3,229,1,66,5.07253,0.009561,191611,55224
167.235.145.223,443,172.71.182.254,13120,5,361,1870,3,229,2,132,17.98545,0.009596,190912,110045
167.235.145.223,443,172.71.242.4,57632,4,295,1628,3,229,1,66,13.654388,0.021897,83664,24112
167.235.145.223,443,172.71.242.32,54374,4,295,747,3,229,1,66,1.651366,0.021244,86236,24854
167.235.145.223,443,172.71.242.58,57250,4,295,1965,3,229,1,66,19.643515,0.022326,82056,23649
167.235.145.223,443,172.71.242.126,64594,4,295,1252,3,229,1,66,7.585349,0.020663,88660,25552
167.235.145.223,443,172.71.242.141,38980,4,295,2335,3,229,1,66,25.645596,0.021542,85043,24510
167.235.145.223,443,172.71.246.13,13864,4,295,1373,3,229,1,66,9.418565,0.004124,,
167.235.145.223,443,172.71.246.18,26286,4,295,2084,3,229,1,66,21.431499,0.004235,,
167.235.145.223,443,172.71.246.25,47204,4,295,1722,3,229,1,66,15.381117,0.004026,,
167.235.145.223,443,172.71.246.54,58758,4,295,410,3,229,1,66,0.710475,0.004139,,
167.235.145.223,443,172.71.246.74,45088,4,295,1191,3,229,1,66,6.697419,0.00412,,
167.235.145.223,443,172.71.246.80,48046,4,295,2443,3,229,1,66,27.410661,0.004124,,
167.235.145.223,443,172.71.246.125,30172,4,295,954,3,229,1,66,3.405416,0.004136,,
167.235.145.223,443,172.71.246.134,26344,4,295,1916,3,229,1,66,18.981392,0.004212,,
167.235.145.223,443,172.71.250.58,31482,4,295,1612,3,229,1,66,13.498844,0.00419,,
167.235.145.223,443,172.71.250.80,11748,5,361,1243,3,229,2,132,7.485778,0.004044,,
167.235.145.223,443,172.71.250.91,53754,4,295,1948,3,229,1,66,19.487617,0.004034,,
167.235.145.223,443,172.71.250.93,18938,4,295,2320,3,229,1,66,25.509425,0.004041,,
167.235.145.223,443,172.71.254.50,16348,5,361,1949,3,229,2,132,19.492359,0.129642,14131,8145
167.235.145.223,443,172.71.254.95,19020,5,361,2316,3,229,2,132,25.402449,0.104784,17483,10077
167.235.145.223,443,172.71.254.182,49260,4,295,687,3,229,1,66,1.449527,0.105759,17322,4992
167.235.145.223,443,172.71.254.198,64802,4,295,1611,3,229,1,66,13.495398,0.133052,13769,3968
167.235.145.223,443,188.114.102.11,21394,5,361,816,3,229,2,132,1.987451,0.018272,100262,57793
167.235.145.223,443,188.114.102.12,33934,4,295,1125,3,229,1,66,5.471601,0.018358,99793,28761
167.235.145.223,443,188.114.102.26,41410,5,361,874,3,229,2,132,2.379452,0.021219,86337,49766
167.235.145.223,443,188.114.102.64,14692,5,361,2047,3,229,2,132,20.681585,0.018644,98262,56640
167.235.145.223,443,188.114.102.70,52224,4,295,2399,3,229,1,66,26.389422,0.018652,98220,28307
167.235.145.223,443,188.114.102.79,43414,4,295,1908,3,229,1,66,18.886394,0.021157,86590,24956
167.235.145.223,443,188.114.102.82,12632,4,295,1532,3,229,1,66,12.138492,0.021775,84133,24247
167.235.145.223,443,188.114.102.89,56156,4,295,1844,3,229,1,66,17.542514,0.018471,99182,28585
167.235.145.223,443,188.114.102.104,40174,4,295,2162,3,229,1,66,23.050413,0.0186,98494,28387
167.235.145.223,443,188.114.102.104,40168,4,295,2229,3,229,1,66,23.878469,0.012688,144388,41614
167.235.145.223,443,188.114.102.133,11040,4,295,1697,3,229,1,66,14.670412,0.018577,98616,28422
167.235.145.223,443,188.114.102.144,48940,4,295,974,3,229,1,66,3.665425,0.018448,99306,28620
167.235.145.223,443,188.114.102.152,37656,4,295,363,3,229,1,66,0.620298,0.021155,86598,24958
167.235.145.223,443,188.114.102.162,24882,4,295,1502,3,229,1,66,11.571464,0.018643,98267,28321
167.235.145.223,443,188.114.102.172,18368,4,295,1475,3,229,1,66,11.147297,0.018469,99193,28588
167.235.145.223,443,188.114.102.190,64842,4,295,2234,3,229,1,66,24.128447,0.013184,138956,40048
167.235.145.223,443,188.114.102.224,10336,4,295,1858,3,229,1,66,17.76639,0.012794,143192,41269
167.235.145.223,443,188.114.102.247,26330,395,242493,0,132,122509,263,119984,0,81.882991,11969,11722
167.235.145.223,35238,195.130.73.227,5555,48,5775,960,32,2368,16,3407,3.469362,75.889121,249,359
167.235.145.223,58678,195.130.73.227,5555,24218,96913837,525,6269,423392,17949,96490445,0.970453,80.674116,41985,9568416
167.235.145.223,58764,195.130.73.227,5555,16718,57615343,610,4346,293242,12372,57322101,1.185116,80.863234,29011,5671017
167.235.145.223,443,198.41.230.69,36032,5,361,1410,3,229,2,132,10.375828,0.225491,8124,4683
167.235.145.223,443,198.41.230.114,57264,4,295,1012,3,229,1,66,4.380463,0.225258,8132,2343
167.235.145.223,443,198.41.230.163,15632,4,295,2113,3,229,1,66,22.378168,0.227252,8061,2323
167.235.145.223,443,198.41.230.182,14942,5,361,2448,3,229,2,132,27.693485,0.225541,8122,4682
167.235.145.223,443,198.41.230.184,49294,4,295,1762,3,229,1,66,16.358565,0.217292,8431,2429
167.235.145.223,443,198.41.242.13,63460,4,295,2005,3,229,1,66,20.036348,0.013164,139167,40109
167.235.145.223,443,198.41.242.111,46608,4,295,821,3,229,1,66,2.011422,0.006297,290932,83849
167.235.145.223,443,198.41.242.171,60302,4,295,1665,3,229,1,66,14.010645,0.013205,138735,39984
167.235.145.223,443,198.41.242.207,38542,4,295,2378,3,229,1,66,26.044349,0.013577,134934,38889
172.68.50.72,26026,167.235.145.223,443,33,17235,3591,19,6615,14,10620,79.841382,1.99954,26466,42489
172.68.50.72,50004,167.235.145.223,443,377,231407,117,251,116350,126,115057,0.191181,54.827076,16977,16788
172.68.50.72,52742,167.235.145.223,443,654,407137,156,436,205108,218,202029,0.257135,82.840417,19807,19510
172.68.50.73,21754,167.235.145.223,443,651,405639,397,434,204682,217,200957,0.689772,82.062953,19953,19590
172.68.50.73,48618,167.235.145.223,443,651,405572,183,434,204299,217,201273,0.298511,81.754687,19991,19695
172.68.50.73,58358,167.235.145.223,443,284,173057,384,189,86653,95,86404,0.663201,42.430021,16338,16291
172.68.50.75,36920,167.235.145.223,443,250,2471263,2137,124,10384,126,2460879,22.773143,30.496069,2724,645559
172.68.50.82,25692,167.235.145.223,443,1785,2638632,2475,795,55260,990,2583372,28.350348,33.022916,13387,625837
172.68.50.83,25554,167.235.145.223,443,396,4976183,2477,188,14859,208,4961324,28.415887,30.62841,3881,1295875
172.68.50.84,51712,167.235.145.223,443,348,212980,2598,229,105425,119,107555,30.802092,51.572813,16353,16683
172.68.50.84,57406,167.235.145.223,443,595,368725,1,397,185189,198,183536,0.000403,82.45576,17967,17806
172.68.50.84,57408,167.235.145.223,443,591,368493,96,394,185922,197,182571,0.158395,81.822807,18178,17850
172.68.50.85,38910,167.235.145.223,443,597,373986,27,398,189637,199,184349,0.043823,82.87152,18306,17796
172.68.50.85,55782,167.235.145.223,443,594,371484,145,396,188052,198,183432,0.23282,82.154013,18312,17862
172.68.50.146,26624,167.235.145.223,443,6,427,2532,2,132,4,295,29.189876,29.762221,35,79
172.68.50.146,27686,167.235.145.223,443,815,1213347,10,360,24236,455,1189111,0.006901,59.026435,3284,161163
172.68.50.146,27688,167.235.145.223,443,6,427,2531,2,132,4,295,29.189138,29.851495,35,79
172.68.50.149,22148,167.235.145.223,443,7,493,1801,3,198,4,295,16.952189,29.612295,53,79
172.68.50.151,22558,167.235.145.223,443,1015,5218501,2863,415,31141,600,5187360,43.405776,34.070291,7312,1218037
172.68.50.164,60644,167.235.145.223,443,190,2041092,2799,82,6899,108,2034193,41.067919,30.312141,1820,536865
172.68.50.165,19316,167.235.145.223,443,247,4068339,2792,106,9387,141,4058952,40.976682,30.914205,2429,1050378
172.68.50.174,24694,167.235.145.223,443,7,493,2303,3,198,4,295,25.260148,29.69016,53,79
172.68.50.251,34716,167.235.145.223,443,214,2710017,1166,104,9118,110,2700899,6.177463,60.843591,1198,355126
172.68.50.252,34728,167.235.145.223,443,308,2336623,1535,117,10022,191,2326601,12.178514,65.944437,1215,282249
172.68.50.254,13986,167.235.145.223,443,210,2064306,1615,93,6871,117,2057435,13.530929,65.761563,835,250290
172.68.50.254,13988,167.235.145.223,443,389,4126998,1557,150,11830,239,4115168,12.57185,68.78489,1375,478613
172.68.51.18,43984,167.235.145.223,443,635,4880073,2818,297,23415,338,4856658,41.251023,12.353725,15163,3145064
172.68.51.21,50174,167.235.145.223,443,378,2436394,3043,171,12984,207,2423410,52.793184,30.259586,3432,640698
172.68.51.22,27724,167.235.145.223,443,502,12602184,2916,225,19728,277,12582456,46.767111,6.221343,25368,16179729
172.68.51.26,46580,167.235.145.223,443,417,8929393,50,186,17237,231,8912156,0.078134,66.345186,2078,1074640
172.68.51.27,53124,167.235.145.223,443,928,1846953,34,612,283883,316,1563070,0.049975,81.814655,27758,152840
172.68.51.28,20062,167.235.145.223,443,893,556300,46,595,280203,298,276097,0.071534,83.03333,26996,26601
172.68.51.28,56996,167.235.145.223,443,931,1846663,63,615,283603,316,1563060,0.0956,81.781251,27742,152901
172.68.51.38,34484,167.235.145.223,443,6,427,2290,2,132,4,295,25.014805,29.996806,35,78
172.68.51.40,34842,167.235.145.223,443,670,7262701,1161,282,21273,388,7241428,6.146085,60.802553,2798,952779
172.68.51.44,17770,167.235.145.223,443,7,493,870,3,198,4,295,2.33526,29.702533,53,79
172.68.51.44,17788,167.235.145.223,443,6,427,934,2,132,4,295,3.102241,28.287195,37,83
172.68.51.45,61854,167.235.145.223,443,212,7404223,1432,87,8348,125,7395875,10.786453,60.551083,1102,977141
172.68.51.47,16142,167.235.145.223,443,1352,6526322,3153,634,45141,718,6481181,57.831338,0.990617,364548,52340559
172.68.51.49,29284,167.235.145.223,443,695,430898,31,463,215761,232,215137,0.047881,83.049167,20783,20723
172.68.51.49,41592,167.235.145.223,443,696,427707,44,464,212786,232,214921,0.067966,81.897099,20785,20994
172.68.51.50,30046,167.235.145.223,443,696,429802,20,464,214882,232,214920,0.01936,82.622387,20806,20809
172.68.51.50,38324,167.235.145.223,443,693,427123,70,462,212968,231,214155,0.117151,81.740274,20843,20959
172.68.51.51,60412,167.235.145.223,443,6,427,1509,2,132,4,295,11.705141,29.538325,35,79
172.68.51.51,60422,167.235.145.223,443,6,427,1508,2,132,4,295,11.705141,29.538435,35,79
172.68.51.53,49442,167.235.145.223,443,6,427,1970,2,132,4,295,19.709563,29.697865,35,79
172.68.51.54,33398,167.235.145.223,443,7,493,1907,3,198,4,295,18.878506,28.134385,56,83
172.68.51.56,9814,167.235.145.223,443,509,2348296,3227,248,17752,261,2330544,61.310472,0.285833,496849,65228129
172.68.51.56,9822,167.235.145.223,443,445,2344216,3229,183,13606,262,2330610,61.394206,0.286453,379985,65088792
172.68.51.56,9832,167.235.145.223,443,486,2347036,3231,224,16426,262,2330610,61.487827,0.284704,461560,65488647
172.68.51.67,19296,167.235.145.223,443,47,1255036,1819,23,2252,24,1252784,17.194495,60.014923,300,166996
172.68.51.68,54956,167.235.145.223,443,179,1263840,1767,83,6304,96,1257536,16.434216,60.016452,840,167625
172.68.51.76,14304,167.235.145.223,443,907,1308696,2261,407,28265,500,1280431,24.51428,35.472034,6374,288775
172.68.51.76,14314,167.235.145.223,443,43,1233794,2082,19,2124,24,1231670,21.405112,60.016589,283,164177
172.68.51.82,64076,167.235.145.223,443,409,9136735,1530,191,17478,218,9119257,12.102026,41.929191,3334,1739934
172.68.51.83,42206,167.235.145.223,443,6,427,1910,2,132,4,295,18.892633,29.603993,35,79
172.68.51.83,62834,167.235.145.223,443,6,427,1943,2,132,4,295,19.403603,29.551955,35,79
172.68.51.86,59724,167.235.145.223,443,7,493,1640,3,198,4,295,13.738082,29.9367,52,78
172.68.51.87,31904,167.235.145.223,443,6,427,1898,2,132,4,295,18.636376,29.577089,35,79
172.68.51.88,23598,167.235.145.223,443,563,1138886,3190,239,17807,324,1121079,59.259474,0.780857,182435,11485626
172.68.51.88,23632,167.235.145.223,443,706,1143864,3207,311,22443,395,1121421,60.025377,0.992972,180814,9034865
172.68.51.93,45510,167.235.145.223,443,229,2387342,3360,113,9100,116,2378242,67.723943,0.144253,504668,131892827
172.68.51.94,46514,167.235.145.223,443,1082,3713407,3346,506,35559,576,3677848,67.291882,6.570557,43294,4477974
172.68.51.94,46518,167.235.145.223,443,1099,3714764,3349,517,36520,582,3678244,67.367659,8.196532,35644,3590049
172.68.51.97,18574,167.235.145.223,443,691,4905303,3281,325,23966,366,4881337,65.145066,1.155031,165993,33809218
172.68.51.97,18592,167.235.145.223,443,357,2455568,3305,158,11602,199,2443966,65.383267,0.239256,387935,81718861
172.68.51.101,55552,167.235.145.223,443,566,1794800,2603,251,18158,315,1776642,30.978917,30.486591,4764,466209
172.68.51.101,55628,167.235.145.223,443,612,1797628,2612,297,20986,315,1776642,31.253611,30.339797,5533,468465
172.68.51.102,19668,167.235.145.223,443,444,1786798,2610,170,12862,274,1773936,31.171804,30.302648,3395,468325
172.68.51.103,32612,167.235.145.223,443,260,2665697,1430,122,9603,138,2656094,10.764039,60.494463,1269,351251
172.68.51.108,49662,167.235.145.223,443,382,9165121,2736,178,16649,204,9148472,37.435395,42.154424,3159,1736182
172.68.51.112,48460,167.235.145.223,443,188,2497409,3622,87,8042,101,2489367,81.423281,1.313627,48975,15160266
172.68.51.118,59120,167.235.145.223,443,7,493,2561,3,198,4,295,29.544046,29.73098,53,79
172.68.51.125,38506,167.235.145.223,443,685,2324002,32,443,202723,242,2121279,0.048242,82.124892,19747,206639
172.68.51.125,58128,167.235.145.223,443,636,399540,69,424,203337,212,196203,0.111578,82.484523,19721,19029
172.68.51.126,20656,167.235.145.223,443,803,2331677,111,501,206072,302,2125605,0.177091,82.673613,19940,205686
172.68.51.126,65132,167.235.145.223,443,505,314300,1666,334,157742,171,156558,14.019577,68.641408,18384,18246
172.68.51.127,42146,167.235.145.223,443,640,2281677,1053,282,20016,358,2261661,4.973717,60.064663,2665,301230
172.68.51.128,56176,167.235.145.223,443,303,4494064,1046,149,12350,154,4481714,4.930287,60.242131,1640,595160
172.68.51.135,10308,167.235.145.223,443,400,8009368,3407,190,15912,210,7993456,70.86754,0.71942,176942,88887781
172.68.51.138,54816,167.235.145.223,443,6,427,2231,2,132,4,295,24.052631,29.829934,35,79
172.68.51.138,54820,167.235.145.223,443,6,427,2186,2,132,4,295,23.22466,29.808433,35,79
172.68.51.140,36288,167.235.145.223,443,193,2612217,3260,91,8306,102,2603911,63.419843,3.181995,20882,6546612
172.68.51.141,32342,167.235.145.223,443,780,482536,249,520,241597,260,240939,0.412585,82.576878,23405,23342
172.68.51.142,24274,167.235.145.223,443,780,481994,192,520,240964,260,241030,0.31053,82.412825,23390,23397
172.68.51.142,37008,167.235.145.223,443,782,484627,43,521,242706,261,241921,0.06399,83.035806,23383,23307
172.68.51.155,45364,167.235.145.223,443,363,1461796,2543,165,12275,198,1449521,29.249949,30.520579,3217,379945
172.68.51.156,15920,167.235.145.223,443,850,1494021,2505,399,27802,451,1466219,28.773929,30.523157,7286,384290
172.68.51.157,19532,167.235.145.223,443,396,246207,290,264,123769,132,122438,0.47221,82.305112,12030,11900
172.68.51.157,53918,167.235.145.223,443,396,244548,132,264,122203,132,122345,0.208964,81.54458,11988,12002
172.68.51.157,54102,167.235.145.223,443,396,245503,212,264,123439,132,122064,0.352011,82.299267,11999,11865
172.68.51.158,40104,167.235.145.223,443,396,244304,267,264,121861,132,122443,0.436428,82.377941,11834,11890
172.68.51.158,40120,167.235.145.223,443,393,243444,324,262,122012,131,121432,0.541863,80.927147,12061,12004
172.68.51.158,40124,167.235.145.223,443,393,241697,340,262,120335,131,121362,0.571945,81.138489,11864,11965
172.68.51.160,25710,167.235.145.223,443,365,8305402,2285,146,12952,219,8292450,24.949176,30.595584,3386,2168273
172.68.51.162,36664,167.235.145.223,443,390,2613188,3390,178,14048,212,2599140,69.436299,0.636005,176703,32693327
172.68.51.164,49216,167.235.145.223,443,569,4258334,2659,249,18831,320,4239503,33.981025,31.143528,4837,1089023
172.68.51.164,49228,167.235.145.223,443,1474,2235359,2660,668,46113,806,2189246,34.034014,31.730555,11626,551959
172.68.51.166,16430,167.235.145.223,443,641,2756185,2949,294,21568,347,2734617,47.250046,31.111997,5545,703167
172.68.51.168,19604,167.235.145.223,443,6,427,828,2,132,4,295,2.050628,29.924841,35,78
172.68.51.173,40700,167.235.145.223,443,638,391404,125,422,196056,216,195348,0.203122,81.541192,19235,19165
172.68.51.174,13486,167.235.145.223,443,646,396781,3,428,199123,218,197658,0.002201,82.335279,19347,19205
172.68.51.174,35760,167.235.145.223,443,640,393566,54,426,196411,214,197155,0.085087,82.148144,19127,19199
172.68.51.174,37394,167.235.145.223,443,641,392217,103,425,196423,216,195794,0.168059,81.870207,19193,19132
172.68.51.179,58118,167.235.145.223,443,176,2321765,2682,78,7350,98,2314415,34.789063,30.491463,1928,607229
172.68.51.184,43924,167.235.145.223,443,341,2478183,1030,161,12177,180,2466006,4.770771,60.62179,1606,325428
172.68.51.185,43946,167.235.145.223,443,6,427,1313,2,132,4,295,8.272818,29.959746,35,78
172.68.51.186,20606,167.235.145.223,443,357,2395789,2856,168,12730,189,2383059,43.303639,30.209211,3371,631081
172.68.51.186,26698,167.235.145.223,443,543,4774787,2842,237,17903,306,4756884,42.386619,31.037312,4614,1226107
172.68.51.186,49260,167.235.145.223,443,6,427,1108,2,132,4,295,5.328892,29.697742,35,79
172.68.51.187,46772,167.235.145.223,443,190,2901111,3425,84,7646,106,2893465,71.285088,0.501705,121920,46138109
172.68.51.191,34080,167.235.145.223,443,280,4588821,2154,127,10773,153,4578048,22.97349,30.678662,2809,1193806
172.68.51.192,23678,167.235.145.223,443,345,2310547,2148,152,11561,193,2298986,22.935695,60.062588,1539,306212
172.68.51.193,32452,167.235.145.223,443,928,4661364,3603,406,28882,522,4632482,80.488987,1.037636,222675,35715661
172.68.51.199,9886,167.235.145.223,443,306,2090815,3112,128,9832,178,2080983,55.307768,0.225295,349124,73893623
172.68.51.200,37808,167.235.145.223,443,986,2135953,3108,458,31870,528,2104083,55.252968,0.54727,465876,30757512
172.68.51.200,37968,167.235.145.223,443,1023,2138281,3114,486,33604,537,2104677,55.376044,0.557261,482416,30214596
172.68.51.202,41524,167.235.145.223,443,351,6523534,3517,174,14802,177,6508732,76.174043,0.983141,120446,52962755
172.68.51.207,43362,167.235.145.223,443,1493,4494237,2720,660,46093,833,4448144,36.943911,36.477174,10108,975545
172.68.51.207,43376,167.235.145.223,443,1495,4494469,2734,700,48833,795,4445636,37.368247,36.395221,10733,977191
172.68.51.208,34166,167.235.145.223,443,1143,4470721,2732,519,36371,624,4434350,37.286315,36.194782,8038,980108
172.68.51.211,41530,167.235.145.223,443,872,2438548,1754,388,28000,484,2410548,16.090028,60.065569,3729,321055
172.68.51.212,19490,167.235.145.223,443,643,4745202,1749,296,21735,347,4723467,15.99241,60.499138,2874,624599
172.68.51.216,25094,167.235.145.223,443,1596,3135527,2444,665,47518,931,3088009,27.419061,38.998889,9747,633455
172.68.51.218,44236,167.235.145.223,443,705,5047503,122,279,22317,426,5025186,0.198192,60.683736,2942,662475
172.68.62.16,47700,167.235.145.223,443,334,1104323,3382,163,12166,171,1092157,68.737668,0.512526,189898,17047439
172.68.62.17,20652,167.235.145.223,443,6,427,1718,2,132,4,295,15.298222,29.725133,35,79
172.68.62.20,12362,167.235.145.223,443,6,427,1359,2,132,4,295,8.991797,29.685891,35,79
172.68.62.25,50716,167.235.145.223,443,6,427,2393,2,132,4,295,26.352998,29.656655,35,79
172.68.62.27,26380,167.235.145.223,443,6,427,831,2,132,4,295,2.059805,29.801363,35,79
172.68.62.30,39930,167.235.145.223,443,77,2052646,780,41,3566,36,2049080,1.798351,60.049015,475,272987
172.68.62.38,53116,167.235.145.223,443,14,7452,784,9,3678,5,3774,1.838559,65.962112,446,457
172.68.62.39,48444,167.235.145.223,443,20,9681,2747,10,2816,10,6865,37.781701,18.011419,1250,3049
172.68.62.43,45154,167.235.145.223,443,7,493,1290,3,198,4,295,7.938859,29.816669,53,79
172.68.62.47,58876,167.235.145.223,443,365,1461951,2772,174,12892,191,1449059,38.810739,30.525495,3378,379763
172.68.62.49,44246,167.235.145.223,443,6,427,2429,2,132,4,295,27.149759,29.685416,35,79
172.68.62.53,23440,167.235.145.223,443,334,1179668,2892,158,11836,176,1167832,44.696581,30.514947,3103,306166
172.68.62.55,32162,167.235.145.223,443,11,5725,1470,7,2882,4,2843,11.104979,62.726037,367,362
172.68.62.60,63040,167.235.145.223,443,373,1471503,3605,182,13420,191,1458083,80.517061,0.48447,221602,24077164
172.68.62.63,55570,167.235.145.223,443,6,427,1688,2,132,4,295,14.461094,29.577968,35,79
172.68.62.73,30336,167.235.145.223,443,495,2061246,2875,240,17351,255,2043895,43.845088,30.683528,4523,532896
172.68.62.75,13600,167.235.145.223,443,23,12510,1497,15,5963,8,6547,11.504003,65.658469,726,797
172.68.62.88,17484,167.235.145.223,443,423,2642360,1703,202,15497,221,2626863,14.766322,48.196855,2572,436022
172.68.62.91,17934,167.235.145.223,443,30,18095,760,20,8832,10,9263,1.711043,69.439257,1017,1067
172.68.62.97,34458,167.235.145.223,443,372,2137496,2749,171,12797,201,2124699,37.82382,30.5488,3351,556407
172.68.62.98,26794,167.235.145.223,443,366,1353557,2046,175,12958,191,1340599,20.681415,60.219396,1721,178095
172.68.62.107,18248,167.235.145.223,443,520,6073490,883,244,19232,276,6054258,2.498188,59.753484,2574,810564
172.68.62.109,59338,167.235.145.223,443,344,1315920,3503,163,12166,181,1303754,74.628687,0.471134,206582,22138143
172.68.62.112,62416,167.235.145.223,443,411,2438385,3127,189,13985,222,2424400,55.833048,0.52688,212344,36811418
172.68.62.116,24208,167.235.145.223,443,441,2178205,3243,204,14975,237,2163230,61.850812,0.662725,180768,26113154
172.68.62.122,13428,167.235.145.223,443,352,1253164,2642,171,12694,181,1240470,32.723729,30.494156,3330,325431
172.68.62.124,50570,167.235.145.223,443,7,493,1330,3,198,4,295,8.454865,29.587628,53,79
172.68.62.124,53908,167.235.145.223,443,388,2457952,3363,181,13457,207,2444495,67.832943,0.487557,220807,40110099
172.68.62.126,32964,167.235.145.223,443,527,2623832,2996,255,18341,272,2605491,49.841884,30.669144,4784,679638
172.68.62.138,33644,167.235.145.223,443,440,2383090,1985,218,15899,222,2367191,19.815093,60.193917,2113,314608
172.68.62.141,39942,167.235.145.223,443,49,1255161,2020,26,2473,23,1252688,20.266376,36.343049,544,275747
172.68.62.144,61884,167.235.145.223,443,6,427,2077,2,132,4,295,21.32771,29.645759,35,79
172.68.62.150,32698,167.235.145.223,443,16,7716,3589,8,1843,8,5873,79.783911,0.221126,66676,212476
172.68.62.151,29674,167.235.145.223,443,10,2392,1972,5,1171,5,1221,19.716379,60.059583,155,162
172.68.62.158,34822,167.235.145.223,443,333,1212779,1352,160,11968,173,1200811,8.894533,60.213821,1590,159539
172.68.62.164,22684,167.235.145.223,443,7,493,936,3,198,4,295,3.111948,29.654906,53,79
172.68.62.177,56978,167.235.145.223,443,428,2496806,1645,204,14975,224,2481831,13.806745,60.201034,1989,329805
172.68.62.181,42622,167.235.145.223,443,357,1383069,3134,168,12496,189,1370573,56.471727,0.509918,196047,21502641
172.68.62.182,56202,167.235.145.223,443,33,19804,1074,22,9612,11,10192,5.080224,68.724806,1118,1186
172.68.62.191,54100,167.235.145.223,443,430,2678266,3489,203,14909,227,2663357,73.840508,0.601115,198417,35445557
172.68.62.196,47578,167.235.145.223,443,333,1233833,3009,158,11836,175,1221997,50.583512,30.513382,3103,320383
172.68.62.212,44766,167.235.145.223,443,21,9748,3126,11,2882,10,6866,55.805785,23.996036,960,2289
172.68.62.214,63054,167.235.145.223,443,475,2319077,2351,232,16823,243,2302254,25.819309,30.554328,4404,602796
172.68.62.222,12658,167.235.145.223,443,443,2199422,3590,211,15437,232,2183985,79.834745,0.533446,231506,32752855
172.68.110.5,34326,167.235.145.223,443,320,6590739,2645,158,13668,162,6577071,32.810189,21.710517,5036,2423552
172.68.110.7,16928,167.235.145.223,443,6,427,1893,2,132,4,295,18.5688,29.865061,35,79
172.68.110.9,38874,167.235.145.223,443,126,2458548,274,68,17866,58,2440682,0.448351,78.04315,1831,250187
172.68.110.9,45314,167.235.145.223,443,48,29816,532,32,14996,16,14820,0.997155,78.036912,1537,1519
172.68.110.14,29746,167.235.145.223,443,6,427,1445,2,132,4,295,10.929834,29.517977,35,79
172.68.110.114,20000,167.235.145.223,443,6,427,2472,2,132,4,295,28.199856,29.721121,35,79
172.68.110.119,41856,167.235.145.223,443,6,427,1838,2,132,4,295,17.354341,29.825654,35,79
172.68.110.122,29410,167.235.145.223,443,237,4067435,2837,113,9606,124,4057829,42.148199,30.3878,2528,1068278
172.68.110.124,45798,167.235.145.223,443,532,8256849,2584,239,20194,293,8236655,30.136948,38.224374,4226,1723853
172.68.110.128,15974,167.235.145.223,443,145,1447366,2589,75,6293,70,1441073,30.227329,30.481842,1651,378211
172.68.110.132,50530,167.235.145.223,443,6,427,1768,2,132,4,295,16.439754,29.674178,35,79
172.68.110.134,48968,167.235.145.223,443,24,15377,1025,16,7953,8,7424,4.70187,77.011329,826,771
172.68.110.135,43582,167.235.145.223,443,21,13242,1507,14,6753,7,6489,11.69398,63.015755,857,823
172.68.110.139,34682,167.235.145.223,443,269,4394666,1875,128,10596,141,4384070,18.1422,60.356879,1404,581086
172.68.110.142,62814,167.235.145.223,443,96,59302,114,64,29656,32,29646,0.183169,80.113001,2961,2960
172.68.110.145,25236,167.235.145.223,443,188,2303188,3505,88,7363,100,2295825,74.881609,0.086273,682762,212889316
172.68.110.147,56490,167.235.145.223,443,245,4309197,3210,115,9926,130,4299271,60.153111,0.343028,231491,100266357
172.68.110.149,28124,167.235.145.223,443,178,2082537,3219,87,7297,91,2075240,60.937796,0.076795,760153,216184907
172.68.110.149,47366,167.235.145.223,443,121,4102861,81,53,4995,68,4097866,0.124767,60.33205,662,543375
172.68.110.152,29464,167.235.145.223,443,162,2220111,3084,68,6043,94,2214068,53.903716,0.08631,560120,205220067
172.68.110.153,30742,167.235.145.223,443,6,427,1233,2,132,4,295,7.356289,29.564504,35,79
172.68.110.154,24420,167.235.145.223,443,202,2316144,3629,102,8287,100,2307857,81.888118,0.083665,792398,220675981
172.68.110.163,27258,167.235.145.223,443,238,4350906,3570,107,9398,131,4341508,78.172044,0.386245,194653,89922365
172.68.110.165,58270,167.235.145.223,443,290,4643751,1057,150,12359,140,4631392,4.995572,57.417596,1721,645292
172.68.110.166,24604,167.235.145.223,443,250,4490198,1157,113,9606,137,4480592,6.122587,60.34357,1273,594010
172.68.110.170,10042,167.235.145.223,443,6,427,493,2,132,4,295,0.897205,29.503748,35,79
172.68.110.172,33784,167.235.145.223,443,243,2779915,2355,129,10069,114,2769846,25.842035,30.165046,2670,734584
172.68.110.174,22646,167.235.145.223,443,6,427,1550,2,132,4,295,12.416433,29.99749,35,78
172.68.110.176,18412,167.235.145.223,443,398,9549753,1913,188,16552,210,9533201,18.918933,59.783598,2214,1275694
172.68.110.183,64190,167.235.145.223,443,274,4877601,3327,131,10982,143,4866619,66.165391,0.353635,248436,110093604
172.68.110.185,41060,167.235.145.223,443,253,4478618,1519,116,10115,137,4468503,11.885345,70.23249,1152,508995
172.68.110.187,56346,167.235.145.223,443,539,14501278,1531,248,21886,291,14479392,12.124862,60.375339,2899,1918583
172.68.110.190,13526,167.235.145.223,443,187,2355041,35,113,35732,74,2319309,0.05072,79.361716,3601,233796
172.68.110.191,30404,167.235.145.223,443,171,2352862,230,98,34482,73,2318380,0.373313,78.902403,3496,235063
172.68.110.192,10008,167.235.145.223,443,7,493,2256,3,198,4,295,24.494543,29.95728,52,78
172.68.130.132,9446,167.235.145.223,443,651,5366421,3479,294,21634,357,5344787,73.537037,1.608618,107590,26580764
172.68.130.132,40632,167.235.145.223,443,174,4106441,745,46,4615,128,4101826,1.642298,61.399531,601,534443
172.68.130.135,60702,167.235.145.223,443,590,13022476,685,184,28529,406,12993947,1.446264,78.065207,2923,1331599
172.68.130.136,35116,167.235.145.223,443,223,4357229,1351,85,12861,138,4344368,8.886381,72.279792,1423,480839
172.68.130.136,56858,167.235.145.223,443,303,10123743,924,141,16718,162,10107025,2.88792,78.086671,1712,1035467
172.68.130.139,22578,167.235.145.223,443,731,9195442,3237,372,28361,359,9167081,61.633621,7.449826,30455,9844075
172.68.130.141,41768,167.235.145.223,443,425,9308768,1263,146,12794,279,9295974,7.691913,49.411951,2071,1505056
172.68.130.145,46260,167.235.145.223,443,258,9526760,2340,109,10352,149,9516408,25.707131,37.594621,2202,2025057
172.68.138.37,15576,167.235.145.223,443,6,427,2349,2,132,4,295,25.780532,29.729024,35,79
172.68.138.65,19612,167.235.145.223,443,6,427,1971,2,132,4,295,19.712165,29.794137,35,79
172.68.138.117,36428,167.235.145.223,443,319,2432142,3115,148,11108,171,2421034,55.414147,0.332032,267636,58332546
172.68.138.191,21756,167.235.145.223,443,6,427,1256,2,132,4,295,7.634868,29.828195,35,79
172.68.139.62,36718,167.235.145.223,443,323,2685513,3476,162,12032,161,2673481,73.365063,0.279677,344168,76473388
172.68.171.146,47716,167.235.145.223,443,159,3670268,123,86,18515,73,3651753,0.199806,78.078066,1897,374164
172.68.171.147,27540,167.235.145.223,443,399,11300695,1060,213,27915,186,11272780,5.010046,72.710832,3071,1240286
172.68.171.149,32550,167.235.145.223,443,631,23701292,479,261,28561,370,23672731,0.852357,79.374022,2878,2385942
172.68.171.151,45614,167.235.145.223,443,322,12105332,178,132,13963,190,12091369,0.294923,82.336002,1356,1174831
172.68.171.152,29428,167.235.145.223,443,380,11014400,842,187,34157,193,10980243,2.15204,77.8642,3509,1128142
172.68.171.152,54922,167.235.145.223,443,327,8303150,584,175,34087,152,8269063,1.112518,81.27637,3355,813920
172.68.171.154,13982,167.235.145.223,443,364,10991544,2248,190,16836,174,10974708,24.325141,54.097948,2489,1622938
172.69.43.142,10100,167.235.145.223,443,6,427,1890,2,132,4,295,18.345293,29.873003,35,79
172.69.43.146,19484,167.235.145.223,443,318,4597362,2981,140,11649,178,4585713,49.203641,18.048225,5163,2032648
172.69.43.153,42834,167.235.145.223,443,7,493,2263,3,198,4,295,24.536972,29.96157,52,78
172.69.43.154,52640,167.235.145.223,443,530,8254643,2620,240,19934,290,8234709,31.520543,28.026905,5689,2350515
172.69.43.182,51926,167.235.145.223,443,314,2498821,486,198,75962,116,2422859,0.866742,80.362951,7561,241191
172.69.43.183,60302,167.235.145.223,443,374,4869074,534,220,78100,154,4790974,0.998667,82.095588,7610,466867
172.69.43.186,37820,167.235.145.223,443,251,2525678,1846,118,10045,133,2515633,17.594846,60.902188,1319,330448
172.69.43.190,59042,167.235.145.223,443,285,2782658,2323,130,10106,155,2772552,25.53516,30.37349,2661,730255
172.69.43.196,62042,167.235.145.223,443,6,427,1251,2,132,4,295,7.559962,29.981231,35,78
172.69.43.216,43790,167.235.145.223,443,267,2073345,1951,127,9908,140,2063437,19.529604,60.09597,1318,274685
172.69.43.222,11074,167.235.145.223,443,427,7314866,3286,204,16618,223,7298248,65.177777,5.199428,25568,11229309
172.69.43.224,35148,167.235.145.223,443,296,2310291,3471,143,10968,153,2299323,73.233594,0.244584,358747,75207634
172.69.43.233,29568,167.235.145.223,443,254,2905490,3435,117,9979,137,2895511,71.632474,0.925915,86219,25017510
172.69.43.241,19664,167.235.145.223,443,513,9071014,2676,265,22082,248,9048932,34.610355,44.041997,4011,1643691
172.69.43.242,48422,167.235.145.223,443,258,160889,88,172,81207,86,79682,0.138163,82.128116,7910,7761
172.69.43.242,56162,167.235.145.223,443,255,159387,308,170,80571,85,78816,0.516447,81.07468,7950,7777
172.69.43.246,18154,167.235.145.223,443,272,3254826,3198,132,11943,140,3242883,59.621613,18.108222,5276,1432667
172.69.65.110,41724,167.235.145.223,443,903,2528133,1518,446,30924,457,2497209,11.876068,60.560592,4085,329879
172.69.65.114,50222,167.235.145.223,443,7,493,1237,3,198,4,295,7.405144,29.023969,54,81
172.69.65.133,44608,167.235.145.223,443,804,2407092,1861,380,26568,424,2380524,17.804629,60.53318,3511,314607
172.69.65.170,28244,167.235.145.223,443,882,2490533,3321,440,30528,442,2460005,65.890322,1.501945,162605,13103036
172.69.65.216,48902,167.235.145.223,443,827,2465818,3082,400,27888,427,2437930,53.818778,1.493151,149418,13061934
172.69.65.226,62064,167.235.145.223,443,7,493,1940,3,198,4,295,19.35983,29.026395,54,81
172.69.65.239,20930,167.235.145.223,443,761,2163148,2707,348,24456,413,2138692,35.879734,31.470139,6216,543675
172.69.67.4,20416,167.235.145.223,443,776,2221377,3564,366,25644,410,2195733,77.825885,1.442263,142243,12179376
172.69.67.47,64442,167.235.145.223,443,821,2203262,3205,412,28680,409,2174582,59.812274,1.478826,155150,11763828
172.69.67.53,52262,167.235.145.223,443,6,427,642,2,132,4,295,1.292312,29.047491,36,81
172.69.67.94,23086,167.235.145.223,443,797,2081155,2834,383,26766,414,2054389,41.880717,31.496248,6798,521811
172.69.67.96,40356,167.235.145.223,443,859,2721037,3447,399,27822,460,2693215,71.845432,1.496718,148709,14395310
172.69.67.119,31022,167.235.145.223,443,845,2533298,2575,423,29406,422,2503892,29.832631,31.562125,7453,634657
172.69.67.134,59164,167.235.145.223,443,799,2340439,2227,382,26700,417,2313739,23.845917,31.631065,6752,585181
172.69.67.160,13360,167.235.145.223,443,7,493,1592,3,198,4,295,13.257737,29.074578,54,81
172.69.67.167,10724,167.235.145.223,443,39,24391,1129,26,12350,13,12041,5.510284,72.145327,1369,1335
172.69.67.172,32008,167.235.145.223,443,7,493,2306,3,198,4,295,25.29002,29.035769,54,81
172.69.67.183,39720,167.235.145.223,443,864,2646051,2962,425,29538,439,2616513,47.800908,31.541688,7491,663632
172.69.70.32,58028,167.235.145.223,443,6,427,1492,2,132,4,295,11.436543,29.267768,36,80
172.69.70.42,42860,167.235.145.223,443,6,427,1842,2,132,4,295,17.444489,29.315152,36,80
172.69.70.58,56442,167.235.145.223,443,672,2072850,2811,307,21695,365,2051155,41.16657,31.293721,5546,524362
172.69.70.78,9102,167.235.145.223,443,772,2519432,1467,371,25919,401,2493513,11.084186,60.463429,3429,329920
172.69.70.92,41734,167.235.145.223,443,748,2481634,3372,365,25523,383,2456111,68.222919,1.25635,162521,15639660
172.69.70.93,37612,167.235.145.223,443,82,1191102,1011,41,3488,41,1187614,4.319189,60.117435,464,158039
172.69.70.104,40492,167.235.145.223,443,747,2460483,3058,351,24599,396,2435884,53.150942,1.256878,156572,15504346
172.69.70.108,24838,167.235.145.223,443,789,2529546,2533,387,26975,402,2502571,29.189968,31.313889,6891,639351
172.69.70.111,58964,167.235.145.223,443,207,2410685,1200,93,6920,114,2403765,6.820153,60.11935,920,319865
172.69.70.138,54810,167.235.145.223,443,6,427,1110,2,132,4,295,5.335963,29.320281,36,80
172.69.70.181,10644,167.235.145.223,443,775,2640122,2933,389,27107,386,2613015,47.10994,31.31866,6924,667465
172.69.70.197,47528,167.235.145.223,443,724,2287250,1360,354,24797,370,2262453,8.992925,60.463585,3280,299347
172.69.70.205,35888,167.235.145.223,443,6,427,2208,2,132,4,295,23.520519,29.277826,36,80
172.69.70.205,43056,167.235.145.223,443,788,2716296,3495,386,26909,402,2689387,74.103581,1.257011,171257,17116076
172.69.70.223,36582,167.235.145.223,443,703,2334048,2166,316,22289,387,2311759,23.080877,31.260565,5704,591610
172.69.71.10,42194,167.235.145.223,443,681,2097568,1248,308,21761,373,2075807,7.53856,60.461987,2879,274659
172.69.71.42,50938,167.235.145.223,443,45,27321,993,30,13425,15,13896,3.994483,76.02243,1412,1462
172.69.71.44,60494,167.235.145.223,443,723,2196739,3181,355,24863,368,2171876,59.11479,1.296649,153398,13399931
172.69.71.71,19946,167.235.145.223,443,748,2484701,1094,356,24929,392,2459772,5.21549,60.466029,3298,325441
172.69.71.128,29360,167.235.145.223,443,873,4335455,2694,433,30793,440,4304662,35.134746,45.39279,5426,758651
172.69.71.161,43490,167.235.145.223,443,716,2401229,1812,330,23213,386,2378016,17.103419,60.464821,3071,314631
172.69.79.143,35096,167.235.145.223,443,42,25023,863,28,12054,14,12969,2.274562,78.113089,1234,1328
172.69.79.174,16282,167.235.145.223,443,328,2191721,3596,144,10904,184,2180817,80.052099,0.430766,202504,40501190
172.69.79.175,30070,167.235.145.223,443,330,2191852,3602,143,10837,187,2181015,80.469808,0.41894,206941,41648255
172.69.79.179,19930,167.235.145.223,443,363,2076547,823,169,12554,194,2063993,2.017124,60.177085,1668,274389
172.69.79.179,19940,167.235.145.223,443,240,2068428,873,103,8197,137,2060231,2.370715,60.094334,1091,274266
172.69.79.186,15274,167.235.145.223,443,6,427,2430,2,132,4,295,27.164488,29.715947,35,79
172.69.79.212,47314,167.235.145.223,443,7,493,1324,3,198,4,295,8.392371,29.994497,52,78
172.69.79.221,42880,167.235.145.223,443,315,4313628,3245,143,11586,172,4302042,62.041781,0.376537,246159,91402268
172.69.79.239,59782,167.235.145.223,443,357,2612500,2999,156,11696,201,2600804,50.035801,30.44051,3073,683511
172.69.79.239,59786,167.235.145.223,443,275,2607088,3008,127,9781,148,2597307,50.416083,30.251166,2586,686864
172.69.79.243,33064,167.235.145.223,443,479,9919947,2372,220,18165,259,9901782,26.001153,48.434928,3000,1635477
172.69.150.9,46096,167.235.145.223,443,197,4316696,2542,88,9111,109,4307585,29.231545,33.491342,2176,1028942
172.69.150.25,48828,167.235.145.223,443,234,9054685,1292,90,8694,144,9045991,7.977366,66.462009,1046,1088861
172.69.150.28,35060,167.235.145.223,443,237,149411,439,158,76225,79,73186,0.775986,80.15146,7608,7304
172.69.150.29,51386,167.235.145.223,443,240,151836,165,160,77718,80,74118,0.269196,81.09934,7666,7311
172.69.150.36,16520,167.235.145.223,443,238,4586026,2156,109,9563,129,4576463,22.986972,30.497755,2508,1200472
172.69.150.37,29230,167.235.145.223,443,183,2299608,2159,88,7090,95,2292518,23.022978,60.027587,944,305528
172.69.150.51,29754,167.235.145.223,443,6,427,2415,2,132,4,295,26.708748,29.97566,35,78
172.69.150.52,43754,167.235.145.223,443,274,6455130,3156,121,11238,153,6443892,58.016814,1.866341,48171,27621498
172.69.150.56,9696,167.235.145.223,443,113,1303726,3510,53,4950,60,1298776,75.355383,0.051622,767114,201274805
172.69.150.61,22014,167.235.145.223,443,309,6921503,2503,141,12544,168,6908959,28.752576,30.472993,3293,1813792
172.69.150.64,56166,167.235.145.223,443,306,190901,136,204,96335,102,94566,0.220811,81.367444,9471,9297
172.69.150.65,32596,167.235.145.223,443,303,187415,151,202,93776,101,93639,0.243362,81.301409,9227,9214
172.69.150.70,57832,167.235.145.223,443,224,4235232,2667,103,8863,121,4226369,34.22964,31.048318,2283,1088978
172.69.150.71,43126,167.235.145.223,443,166,2123919,2669,80,6809,86,2117110,34.273476,30.49207,1786,555451
172.69.150.89,50916,167.235.145.223,443,48,1188874,939,23,2316,25,1186558,3.183961,60.006309,308,158191
172.69.150.90,18260,167.235.145.223,443,297,187243,188,198,95530,99,91713,0.304528,80.329444,9513,9133
172.69.150.90,48796,167.235.145.223,443,297,188117,470,198,96403,99,91714,0.832559,80.343578,9599,9132
172.69.150.115,36160,167.235.145.223,443,171,3248233,3185,81,8649,90,3239584,59.170594,3.529908,19601,7342024
172.69.150.119,27988,167.235.145.223,443,6,427,1853,2,132,4,295,17.667186,29.929459,35,78
172.69.150.122,10554,167.235.145.223,443,264,164696,92,176,83176,88,81520,0.152022,82.659661,8049,7889
172.69.150.122,18620,167.235.145.223,443,264,164503,586,176,82688,88,81815,1.115837,81.959027,8071,7985
172.69.150.123,49670,167.235.145.223,443,102,62397,2979,65,29640,37,32757,49.188247,32.679745,7255,8018
172.69.150.125,22432,167.235.145.223,443,222,4150966,3117,105,9259,117,4141707,55.629304,0.290682,254821,113985922
172.69.150.129,13840,167.235.145.223,443,6,427,2523,2,132,4,295,29.069032,29.527592,35,79
172.69.150.130,49026,167.235.145.223,443,201,4344031,3415,92,9375,109,4334656,71.14965,3.569831,21009,9713974
172.69.150.135,34276,167.235.145.223,443,289,6094610,2794,139,12485,150,6082125,40.984773,30.486489,3276,1596018
172.69.150.143,32254,167.235.145.223,443,340,7990261,3236,158,15409,182,7974852,61.629556,7.078127,17415,9013516
172.69.150.148,59582,167.235.145.223,443,419,4790423,409,246,98391,173,4692032,0.709351,82.248436,9570,456376
172.69.150.149,45328,167.235.145.223,443,306,190039,443,204,95444,102,94595,0.787239,81.887277,9324,9241
172.69.150.157,59922,167.235.145.223,443,6,427,1658,2,132,4,295,13.972799,29.982668,35,78
172.69.150.165,46434,167.235.145.223,443,6,427,2562,2,132,4,295,29.548989,29.534353,35,79
172.69.150.166,28930,167.235.145.223,443,71,2460476,1091,27,3447,44,2457029,5.210379,63.47498,434,309668
172.69.150.172,18440,167.235.145.223,443,257,4491551,1051,119,10190,138,4481361,4.958733,61.409741,1327,583798
172.69.150.173,36534,167.235.145.223,443,184,2251803,1061,89,7500,95,2244303,5.013228,60.031345,999,299084
172.69.150.174,58920,167.235.145.223,443,230,4895840,3544,109,11277,121,4884563,77.156789,3.583435,25175,10904761
172.69.150.177,20394,167.235.145.223,443,41,1158277,1556,18,1989,23,1156288,12.569592,60.007784,265,154151
172.69.150.179,50858,167.235.145.223,443,119,1258946,827,55,5082,64,1253864,2.043987,60.025339,677,167111
172.69.150.180,55646,167.235.145.223,443,123,1322494,514,60,5412,63,1317082,0.954176,60.027336,721,175530
172.69.150.182,43816,167.235.145.223,443,216,135962,265,144,69245,72,66717,0.435302,80.981889,6840,6590
172.69.150.182,56264,167.235.145.223,443,219,137886,250,146,70242,73,67644,0.41277,82.099784,6844,6591
172.69.150.187,30720,167.235.145.223,443,117,1310006,3332,58,5280,59,1304726,66.553592,0.051077,826986,204354366
172.69.150.194,36706,167.235.145.223,443,483,12427663,1411,216,19329,267,12408334,10.428578,58.829807,2628,1687353
172.69.150.198,41162,167.235.145.223,443,7,493,1192,3,198,4,295,6.697996,29.938389,52,78
172.69.150.202,21950,167.235.145.223,443,436,11633483,2810,207,19597,229,11613886,41.149086,31.554515,4968,2944462
172.69.150.210,27360,167.235.145.223,443,171,104999,413,114,52193,57,52806,0.712373,80.307605,5199,5260
172.69.150.211,22328,167.235.145.223,443,171,106379,803,114,53576,57,52803,1.911737,79.754775,5374,5296
172.69.150.213,20488,167.235.145.223,443,6,427,2382,2,132,4,295,26.145508,29.998044,35,78
172.69.150.215,40262,167.235.145.223,443,6,427,865,2,132,4,295,2.281891,29.598388,35,79
172.69.150.219,12824,167.235.145.223,443,235,4754525,2870,103,9127,132,4745398,43.637405,30.360923,2404,1250396
172.69.150.222,53982,167.235.145.223,443,169,3474136,2695,75,8253,94,3465883,35.158652,33.550955,1967,826416
172.69.150.227,11672,167.235.145.223,443,234,143930,344,156,71674,78,72256,0.578814,80.268979,7143,7201
172.69.150.227,60966,167.235.145.223,443,237,147221,144,158,74039,79,73182,0.232117,81.326258,7283,7198
172.69.150.229,9358,167.235.145.223,443,182,4162035,3059,75,8253,107,4153782,53.154653,3.570294,18492,9307428
172.69.150.234,59910,167.235.145.223,443,280,7121558,3049,108,10455,172,7111103,53.009956,20.97797,3987,2711836
172.69.150.235,45044,167.235.145.223,443,234,4711879,3071,101,8613,133,4703266,53.607035,21.732119,3170,1731360
172.69.150.242,29604,167.235.145.223,443,306,190890,273,204,96253,102,94637,0.447801,80.298838,9589,9428
172.69.150.243,56924,167.235.145.223,443,303,188228,394,202,94592,101,93636,0.688113,79.947465,9465,9369
172.69.150.245,50288,167.235.145.223,443,162,2664478,1474,76,7332,86,2657146,11.13914,63.544392,923,334524
172.69.150.252,58572,167.235.145.223,443,114,1324908,1021,51,4818,63,1320090,4.5569,60.030101,642,175923
172.69.150.254,63246,167.235.145.223,443,113,5524811,1904,25,3328,88,5521483,18.7323,37.441089,711,1179769
172.69.151.16,30868,167.235.145.223,443,159,97967,263,106,48798,53,49169,0.425951,79.631575,4902,4939
172.69.151.16,62798,167.235.145.223,443,159,97809,127,106,48641,53,49168,0.204381,79.446649,4897,4951
172.69.151.21,61056,167.235.145.223,443,199,3522682,2625,97,8731,102,3513951,31.630783,30.383112,2298,925237
172.69.151.31,57148,167.235.145.223,443,210,129095,326,140,64184,70,64911,0.550467,82.44609,6227,6298
172.69.151.32,45778,167.235.145.223,443,207,128034,572,138,64095,69,63939,1.080937,81.494894,6291,6276
172.69.151.47,22330,167.235.145.223,443,198,122276,494,132,61133,66,61143,0.897908,81.760896,5981,5982
172.69.151.48,16570,167.235.145.223,443,195,119796,670,130,59580,65,60216,1.398019,80.474943,5922,5986
172.69.151.48,24368,167.235.145.223,443,198,121757,347,132,60617,66,61140,0.582927,81.934151,5918,5969
172.69.151.49,26482,167.235.145.223,443,234,4230140,2743,114,9853,120,4220287,37.618012,30.28245,2602,1114912
172.69.151.59,52712,167.235.145.223,443,160,2519738,1764,78,7473,82,2512265,16.392604,64.311549,929,312511
172.69.151.71,12150,167.235.145.223,443,218,4120595,1963,98,8797,120,4111798,19.630025,60.252491,1168,545942
172.69.151.85,54818,167.235.145.223,443,6,427,2012,2,132,4,295,20.181365,29.905648,35,78
172.69.151.90,17152,167.235.145.223,443,189,119683,622,126,61246,63,58437,1.240856,80.665131,6074,5795
172.69.151.90,28042,167.235.145.223,443,189,119120,11,126,60760,63,58360,0.007855,80.693734,6023,5785
172.69.151.94,53268,167.235.145.223,443,213,4082692,2939,107,10365,106,4072327,47.165212,33.571916,2469,970412
172.69.151.104,55144,167.235.145.223,443,35,1272389,965,11,1527,24,1270862,3.561283,60.008499,203,169424
172.69.151.114,63834,167.235.145.223,443,333,7308716,3293,156,13505,177,7295211,65.208424,1.46972,73510,39709392
172.69.151.120,64304,167.235.145.223,443,6,427,1698,2,132,4,295,14.709961,29.966765,35,78
172.69.151.122,64060,167.235.145.223,443,42,1348166,1183,17,1923,25,1346243,6.564881,60.009669,256,179470
172.69.151.123,31710,167.235.145.223,443,232,4428884,2992,108,9457,124,4419427,49.630476,30.448304,2484,1161162
172.69.151.125,33572,167.235.145.223,443,263,4641569,801,129,10542,134,4631027,1.899699,60.335597,1397,614035
172.69.151.143,50050,167.235.145.223,443,195,2601856,2925,94,7651,101,2594205,47.058574,30.460505,2009,681329
172.69.151.144,12308,167.235.145.223,443,271,5190995,2920,126,10831,145,5180164,46.996065,30.714882,2821,1349225
172.69.151.146,32684,167.235.145.223,443,248,1319147,694,149,49301,99,1269846,1.483807,78.543688,5021,129339
172.69.151.146,36400,167.235.145.223,443,180,1315162,551,114,46326,66,1268836,1.03403,81.679288,4537,124274
172.69.151.146,59594,167.235.145.223,443,144,89176,478,96,44635,48,44541,0.848273,81.407619,4386,4377
172.69.151.166,45222,167.235.145.223,443,6,427,2049,2,132,4,295,20.697209,29.987197,35,78
172.69.151.168,9804,167.235.145.223,443,279,6518722,3534,123,11375,156,6507347,76.78172,1.899879,47897,27401100
172.69.151.194,60100,167.235.145.223,443,6,427,909,2,132,4,295,2.727346,29.957226,35,78
172.69.151.205,31230,167.235.145.223,443,186,115957,537,124,58519,62,57438,1.000138,79.636099,5878,5770
172.69.151.206,10582,167.235.145.223,443,186,115636,657,124,58195,62,57441,1.356495,79.738186,5838,5762
172.69.151.217,39164,167.235.145.223,443,6,427,2206,2,132,4,295,23.48956,29.994713,35,78
172.69.151.217,39174,167.235.145.223,443,6,427,2212,2,132,4,295,23.544643,29.521102,35,79
172.69.151.220,60124,167.235.145.223,443,304,7071601,1751,132,11660,172,7059941,16.041234,60.161712,1550,938795
172.69.151.226,51182,167.235.145.223,443,216,3411077,3639,111,9300,105,3401777,82.457838,0.358002,207820,76016938
172.69.151.230,24634,167.235.145.223,443,104,1282047,3617,46,4488,58,1277559,81.23195,0.051443,697937,198675660
172.69.151.231,28020,167.235.145.223,443,6,427,1318,2,132,4,295,8.331582,29.551887,35,79
172.69.151.232,60546,167.235.145.223,443,6,427,1319,2,132,4,295,8.332645,29.578803,35,79
172.69.151.239,43208,167.235.145.223,443,249,154331,404,166,77446,83,76885,0.699692,80.833051,7664,7609
172.69.165.12,58852,167.235.145.223,443,6,427,2063,2,132,4,295,20.936233,29.025151,36,81
172.69.165.21,50244,167.235.145.223,443,617,1198451,2730,279,19927,338,1178524,37.241795,31.651101,5036,297878
172.69.194.4,12616,167.235.145.223,443,6,427,1647,2,132,4,295,13.839281,29.715059,35,79
172.69.194.20,10680,167.235.145.223,443,405,3715256,724,223,53303,182,3661953,1.581384,80.023826,5328,366086
172.69.194.20,38346,167.235.145.223,443,233,3703318,615,132,46710,101,3656608,1.20636,80.213264,4658,364688
172.69.194.21,43796,167.235.145.223,443,199,2496261,751,115,45830,84,2450431,1.658939,80.702046,4543,242911
172.69.194.23,11208,167.235.145.223,443,377,7447018,2493,158,13414,219,7433604,28.612577,34.720669,3090,1712778
172.69.194.26,13152,167.235.145.223,443,247,2784534,3073,109,9451,138,2775083,53.628245,0.894068,84566,24831068
172.69.194.28,59140,167.235.145.223,443,497,9891437,1463,230,19175,267,9872262,11.027474,63.555324,2413,1242666
172.69.194.31,35166,167.235.145.223,443,83,2315218,702,41,3581,42,2311637,1.515302,60.027568,477,308076
172.69.194.34,10454,167.235.145.223,443,231,2470066,2214,106,9253,125,2460813,23.609213,30.877235,2397,637573
172.69.194.47,62080,167.235.145.223,443,236,1944829,3645,111,8952,125,1935877,82.602377,0.246034,291081,62946649
172.69.194.67,62294,167.235.145.223,443,7,493,2004,3,198,4,295,20.029632,29.921862,52,78
172.69.194.78,57722,167.235.145.223,443,123,77323,506,82,39571,41,37752,0.937502,81.303478,3893,3714
172.69.194.79,11170,167.235.145.223,443,123,78103,201,82,40354,41,37749,0.317354,79.874937,4041,3780
172.69.194.79,29938,167.235.145.223,443,126,80564,84,84,41576,42,38988,0.125739,82.116001,4050,3798
172.69.194.81,23474,167.235.145.223,443,416,6763382,1059,195,16217,221,6747165,5.009562,63.587231,2040,848870
172.69.194.96,62000,167.235.145.223,443,425,3698931,704,238,68567,187,3630364,1.5218,80.904533,6780,358977
172.69.194.97,38720,167.235.145.223,443,195,120586,726,130,60364,65,60222,1.583422,81.067111,5956,5942
172.69.194.97,49334,167.235.145.223,443,198,122725,414,132,61505,66,61220,0.715026,82.379864,5972,5945
172.69.194.100,17790,167.235.145.223,443,304,3889750,3312,151,13197,153,3876553,65.625481,14.842586,7113,2089421
172.69.194.104,11622,167.235.145.223,443,225,2325055,2704,102,8989,123,2316066,35.601333,30.976354,2321,598150
172.69.194.116,20236,167.235.145.223,443,6,427,317,2,132,4,295,0.528854,29.965586,35,78
172.69.194.124,14824,167.235.145.223,443,278,2429653,1245,130,10106,148,2419547,7.516724,60.09632,1345,322089
172.69.194.127,59438,167.235.145.223,443,264,2127376,2740,127,9908,137,2117468,37.526393,30.242306,2620,560134
172.69.194.136,30100,167.235.145.223,443,135,85481,576,90,43783,45,41698,1.087113,78.929735,4437,4226
172.69.194.137,63064,167.235.145.223,443,132,83456,628,88,42698,44,40758,1.257047,78.588556,4346,4149
172.69.194.144,12692,167.235.145.223,443,6,427,1180,2,132,4,295,6.536721,29.939014,35,78
172.69.194.154,28626,167.235.145.223,443,252,154098,255,168,76206,84,77892,0.419936,81.137731,7513,7679
172.69.194.155,61864,167.235.145.223,443,249,153255,296,166,76219,83,77036,0.487553,80.935937,7533,7614
172.69.194.168,45464,167.235.145.223,443,128,2056128,869,61,5001,67,2051127,2.304985,60.026827,666,273361
172.69.194.174,36792,167.235.145.223,443,6,427,1967,2,132,4,295,19.671567,29.641996,35,79
172.69.194.177,50674,167.235.145.223,443,7,493,1295,3,198,4,295,8.00933,29.604408,53,79
172.69.194.180,59516,167.235.145.223,443,6,427,1981,2,132,4,295,19.771929,29.853456,35,79
172.69.194.196,58420,167.235.145.223,443,147,90357,496,98,44964,49,45393,0.901717,80.740105,4455,4497
172.69.194.197,65244,167.235.145.223,443,150,92306,237,100,45989,50,46317,0.387322,82.096491,4481,4513
172.69.194.202,65194,167.235.145.223,443,6,427,1669,2,132,4,295,14.033169,29.946507,35,78
172.69.194.210,55534,167.235.145.223,443,270,2136827,1614,129,10040,141,2126787,13.526505,60.092176,1336,283136
172.69.194.214,9662,167.235.145.223,443,66,42023,247,44,21641,22,20382,0.409671,79.67307,2172,2046
172.69.194.215,52898,167.235.145.223,443,66,42136,513,44,21757,22,20379,0.947141,81.707233,2130,1995
172.69.194.246,54210,167.235.145.223,443,234,2458232,3558,108,9385,126,2448847,77.657221,0.879589,85358,22272647
172.69.194.248,45040,167.235.145.223,443,120,74243,476,80,37187,40,37056,0.840521,79.439489,3744,3731
172.69.194.249,25776,167.235.145.223,443,120,74170,272,80,37116,40,37054,0.446063,79.684895,3726,3720
172.69.194.250,33510,167.235.145.223,443,385,9275297,2829,152,14056,233,9261241,41.625862,40.535041,2774,1827799
172.69.195.9,20506,167.235.145.223,443,47,1188789,291,23,2296,24,1186493,0.474728,60.025684,306,158131
172.69.195.13,20764,167.235.145.223,443,138,85235,153,92,42623,46,42612,0.251803,79.169176,4307,4305
172.69.195.13,34498,167.235.145.223,443,138,84692,155,92,42085,46,42607,0.256261,79.309952,4245,4297
172.69.195.23,60048,167.235.145.223,443,262,2389404,2867,121,9512,141,2379892,43.530054,30.391741,2503,626457
172.69.195.43,30616,167.235.145.223,443,247,2186504,3545,110,8789,137,2177715,77.170275,0.31804,221079,54778392
172.69.195.44,61490,167.235.145.223,443,277,4353572,3536,109,9622,168,4343950,76.934641,0.684336,112482,50781487
172.69.195.51,50894,167.235.145.223,443,173,1000396,2838,74,6414,99,993982,42.259336,30.491501,1682,260789
172.69.195.53,37296,167.235.145.223,443,180,110554,65,120,54961,60,55593,0.09801,82.463643,5331,5393
172.69.195.53,45238,167.235.145.223,443,177,109420,663,118,54689,59,54731,1.369239,81.042574,5398,5402
172.69.195.54,16542,167.235.145.223,443,174,107782,674,116,54028,58,53754,1.414295,80.967671,5338,5311
172.69.195.68,63098,167.235.145.223,443,6,427,2345,2,132,4,295,25.756362,29.853442,35,79
172.69.195.69,27654,167.235.145.223,443,379,6877682,2124,162,13678,217,6864004,22.607497,34.883114,3136,1574172
172.69.195.71,30966,167.235.145.223,443,165,105427,566,110,54479,55,50948,1.0654,80.456957,5416,5065
172.69.195.72,15958,167.235.145.223,443,165,105660,589,110,54710,55,50950,1.119098,81.850209,5347,4979
172.69.195.89,10892,167.235.145.223,443,275,2320937,3633,134,10374,141,2310563,82.316309,0.255136,325285,72449611
172.69.195.89,17888,167.235.145.223,443,6,427,2394,2,132,4,295,26.366357,29.972348,35,78
172.69.195.131,28826,167.235.145.223,443,219,134728,531,146,67109,73,67619,0.990349,80.142979,6698,6749
172.69.195.131,30026,167.235.145.223,443,216,132885,558,144,66116,72,66769,1.046236,79.093075,6687,6753
172.69.195.132,50718,167.235.145.223,443,21,9944,3583,11,3078,10,6866,79.521121,0.853884,28837,64327
172.69.195.135,41654,167.235.145.223,443,289,2333922,3224,139,10704,150,2323218,61.248871,0.237799,360102,78157368
172.69.195.151,20450,167.235.145.223,443,506,7415337,3105,209,16999,297,7398338,55.209003,16.450883,8266,3597782
172.69.195.151,49076,167.235.145.223,443,298,2684151,3418,141,10934,157,2673217,71.187377,0.255762,342005,83615767
172.69.195.157,13622,167.235.145.223,443,7,493,1552,3,198,4,295,12.5045,29.987805,52,78
172.69.195.169,38164,167.235.145.223,443,6,427,1896,2,132,4,295,18.630703,29.856469,35,79
172.69.195.193,27046,167.235.145.223,443,114,70005,764,76,34805,38,35200,1.716638,79.506081,3502,3541
172.69.195.194,14962,167.235.145.223,443,114,70178,658,76,34980,38,35198,1.357271,78.774798,3552,3574
172.69.195.194,54364,167.235.145.223,443,114,70283,744,76,35083,38,35200,1.640507,78.963084,3554,3566
172.69.195.224,57980,167.235.145.223,443,288,2479876,1132,137,11299,151,2468577,5.587899,60.899077,1484,324284
172.69.195.235,9848,167.235.145.223,443,247,2670030,1503,113,9715,134,2660315,11.598335,60.899546,1276,349469
172.69.195.238,17780,167.235.145.223,443,222,2043018,2807,93,7439,129,2035579,41.126625,30.241769,1967,538481
172.69.195.239,39306,167.235.145.223,443,310,4072604,2796,143,11937,167,4060667,41.041694,34.898016,2736,930864
172.69.195.247,52934,167.235.145.223,443,6,427,748,2,132,4,295,1.653143,29.918467,35,78
172.69.195.248,26442,167.235.145.223,443,168,105505,446,112,53629,56,51876,0.788738,80.723124,5314,5141
172.69.195.249,62652,167.235.145.223,443,168,106355,302,112,54407,56,51948,0.50239,80.832571,5384,5141
172.69.222.29,44104,167.235.145.223,443,180,1371268,2874,87,7030,93,1364238,43.771315,30.162839,1864,361832
172.69.222.30,10366,167.235.145.223,443,219,3251382,3206,103,10083,116,3241299,59.885321,1.825174,44195,14207079
172.69.222.43,13918,167.235.145.223,443,6,427,2282,2,132,4,295,24.909133,29.903569,35,78
172.69.222.45,42870,167.235.145.223,443,6,427,1276,2,132,4,295,7.847358,29.924928,35,78
172.69.222.55,57262,167.235.145.223,443,471,6468111,3173,222,17883,249,6450228,58.807384,1.155331,123829,44664104
172.69.222.71,60164,167.235.145.223,443,281,4155055,3089,128,10973,153,4144082,54.219197,3.892293,22553,8517512
172.69.222.74,33170,167.235.145.223,443,982,4297842,1568,400,28984,582,4268858,12.788924,62.359975,3718,547640
172.69.222.76,41136,167.235.145.223,443,277,3888022,3320,134,12129,143,3875893,65.861589,5.747415,16882,5394972
172.69.222.77,9998,167.235.145.223,443,7,493,2098,3,198,4,295,21.845292,29.905211,52,78
172.69.222.91,22540,167.235.145.223,443,307,4126600,1929,151,12426,156,4114174,19.214902,62.304847,1595,528263
172.69.222.102,54842,167.235.145.223,443,424,10266177,2833,195,18555,229,10247622,41.865085,13.08601,11343,6264780
172.69.222.105,44492,167.235.145.223,443,7,493,2342,3,198,4,295,25.720639,29.975456,52,78
172.69.222.106,62720,167.235.145.223,443,181,1277912,2748,89,7162,92,1270750,37.786844,30.165022,1899,337012
172.69.222.116,40980,167.235.145.223,443,390,7077372,1765,181,14990,209,7062382,16.397372,61.287658,1956,921866
172.69.222.129,11904,167.235.145.223,443,339,6553102,3548,155,13501,184,6539601,77.19664,0.864058,125000,60547796
172.69.222.144,55848,167.235.145.223,443,361,6352405,2686,178,14995,183,6337410,34.953909,30.773969,3898,1647472
172.69.222.149,19126,167.235.145.223,443,512,12589493,2511,240,23537,272,12565956,28.916754,53.525508,3517,1878125
172.69.222.154,23002,167.235.145.223,443,234,4084059,2963,106,10281,128,4073778,47.866497,34.339682,2395,949054
172.69.222.161,9344,167.235.145.223,443,335,4165981,2228,158,14337,177,4151644,23.862064,32.354749,3544,1026530
172.69.222.163,15030,167.235.145.223,443,6,427,1980,2,132,4,295,19.768562,29.976681,35,78
172.69.222.164,57978,167.235.145.223,443,6,427,2057,2,132,4,295,20.873951,29.981562,35,78
172.69.222.166,30734,167.235.145.223,443,867,544140,135,578,276651,289,267489,0.21104,82.881532,26703,25818
172.69.222.166,58352,167.235.145.223,443,858,537402,234,572,272317,286,265085,0.384198,82.015719,26562,25856
172.69.222.167,11122,167.235.145.223,443,867,543180,118,578,275225,289,267955,0.194013,82.624018,26648,25944
172.69.222.167,21352,167.235.145.223,443,867,543046,126,578,275493,289,267553,0.203805,82.627529,26673,25904
172.69.222.169,17918,167.235.145.223,443,253,2681181,3444,121,9614,132,2671567,71.774362,0.163605,470107,130634980
172.69.222.169,32846,167.235.145.223,443,680,9172466,1872,302,25002,378,9147464,18.026072,53.816005,3716,1359813
172.69.222.172,10390,167.235.145.223,443,579,363989,217,386,185047,193,178942,0.356101,82.667349,17907,17316
172.69.222.172,12504,167.235.145.223,443,585,365814,203,390,185016,195,180798,0.3299,82.50427,17940,17531
172.69.222.172,25256,167.235.145.223,443,585,364738,150,390,183943,195,180795,0.241982,82.26821,17887,17581
172.69.222.173,18196,167.235.145.223,443,582,363085,147,388,183149,194,179936,0.235924,82.233239,17817,17504
172.69.222.173,49616,167.235.145.223,443,582,365022,232,388,185300,194,179722,0.379312,81.878878,18104,17559
172.69.222.174,32644,167.235.145.223,443,383,7248544,3029,178,14739,205,7233805,52.256267,1.498666,78677,38614634
172.69.222.178,43858,167.235.145.223,443,757,472174,42,504,237881,253,234293,0.0638,83.040457,22917,22571
172.69.222.179,14422,167.235.145.223,443,808,1708230,164,532,242584,276,1465646,0.269196,82.689481,23469,141797
172.69.222.179,23590,167.235.145.223,443,925,1705773,71,590,241516,335,1464257,0.117581,81.502139,23706,143726
172.69.222.179,45228,167.235.145.223,443,768,478370,190,512,241088,256,237282,0.307612,81.382726,23699,23325
172.69.222.181,36752,167.235.145.223,443,7,493,1147,3,198,4,295,5.935353,29.683112,53,79
172.69.222.181,36758,167.235.145.223,443,7,493,1158,3,198,4,295,6.126601,29.758727,53,79
172.69.222.182,35716,167.235.145.223,443,364,6732348,1047,172,14609,192,6717739,4.936939,62.053379,1883,866059
172.69.222.184,26084,167.235.145.223,443,417,259613,77,278,130628,139,128985,0.121729,82.639548,12645,12486
172.69.222.184,26094,167.235.145.223,443,417,259137,177,278,130062,139,129075,0.292949,82.651131,12589,12493
172.69.222.184,36596,167.235.145.223,443,417,259965,60,278,130963,139,129002,0.092561,82.392833,12715,12525
172.69.222.185,33526,167.235.145.223,443,416,258534,242,277,129686,139,128848,0.394729,82.700329,12545,12464
172.69.222.185,49048,167.235.145.223,443,417,258739,206,278,129894,139,128845,0.333145,81.567509,12739,12636
172.69.222.204,46672,167.235.145.223,443,189,1510461,2348,89,7162,100,1503299,25.779662,30.488391,1879,394458
172.69.222.206,23018,167.235.145.223,443,171,1202167,3150,83,6997,88,1195170,57.708434,0.160321,349149,59638849
172.69.222.236,34446,167.235.145.223,443,7,493,846,3,198,4,295,2.194851,29.722651,53,79
172.69.222.243,11348,167.235.145.223,443,165,1225632,2995,75,6238,90,1219394,49.804522,30.159692,1654,323449
172.69.223.8,54340,167.235.145.223,443,6,427,2423,2,132,4,295,26.925954,29.983673,35,78
172.69.223.14,57784,167.235.145.223,443,177,5204974,1404,90,8386,87,5196588,10.220478,59.903025,1119,694000
172.69.223.22,33594,167.235.145.223,443,309,4072054,2804,152,12047,157,4060007,41.087483,30.327136,3177,1070989
172.69.223.22,33606,167.235.145.223,443,204,2042157,2820,100,8228,104,2033929,41.291726,30.144588,2183,539779
172.69.223.24,39092,167.235.145.223,443,181,1362543,1390,86,7195,95,1355348,9.765345,60.072797,958,180494
172.69.223.34,53738,167.235.145.223,443,439,7957495,2516,211,17945,228,7939550,28.948844,30.862688,4651,2058032
172.69.223.36,16116,167.235.145.223,443,347,4762048,3362,182,14472,165,4747576,67.773356,2.236471,51767,16982383
172.69.223.40,28926,167.235.145.223,443,265,4167496,3083,135,12195,130,4155301,53.876471,4.626292,21088,7185540
172.69.223.47,23356,167.235.145.223,443,356,6026440,2310,167,13674,189,6012766,25.318288,32.213153,3395,1493244
172.69.223.51,37960,167.235.145.223,443,7,493,1327,3,198,4,295,8.434573,29.937527,52,78
172.69.223.54,26672,167.235.145.223,443,52,1159070,1707,28,2716,24,1156354,14.889826,60.831192,357,152073
172.69.223.62,31912,167.235.145.223,443,149,1306169,3393,66,5875,83,1300294,69.798363,0.177953,264114,58455614
172.69.223.74,50208,167.235.145.223,443,159,1255606,3630,79,6733,80,1248873,81.997737,0.133742,402745,74703414
172.69.223.82,15356,167.235.145.223,443,259,4347774,3455,124,11403,135,4336371,72.206013,2.498942,36505,13882262
172.69.223.91,40232,167.235.145.223,443,378,7781844,2930,170,14468,208,7767376,47.095593,30.705635,3769,2023700
172.69.223.97,39402,167.235.145.223,443,6,427,1772,2,132,4,295,16.476519,29.708365,35,79
172.69.223.104,9222,167.235.145.223,443,330,4953628,1447,160,12830,170,4940798,10.932859,60.771252,1688,650412
172.69.223.104,9226,167.235.145.223,443,245,2484845,1469,120,9548,125,2475297,11.098557,60.063009,1271,329693
172.69.223.107,33254,167.235.145.223,443,319,4909346,3221,150,12504,169,4896842,61.190256,2.895974,34541,13527309
172.69.223.110,9170,167.235.145.223,443,165,1328341,978,80,6799,85,1321542,3.713089,60.061504,905,176025
172.69.223.114,61046,167.235.145.223,443,327,4760729,2861,161,13086,166,4747643,43.379386,32.381792,3232,1172916
172.69.223.129,64714,167.235.145.223,443,6,427,2466,2,132,4,295,28.091529,29.599304,35,79
172.69.223.133,65318,167.235.145.223,443,158,1285678,3530,77,6601,81,1279077,76.642268,0.186032,283865,55004601
172.69.223.137,16014,167.235.145.223,443,305,3529810,2614,144,11964,161,3517846,31.295321,32.20917,2971,873750
172.69.223.140,43856,167.235.145.223,443,221,3477585,2664,105,10251,116,3467334,34.149975,34.810493,2355,796848
172.69.223.141,24396,167.235.145.223,443,6,427,1524,2,132,4,295,11.948694,29.986587,35,78
172.69.223.147,57896,167.235.145.223,443,339,4839875,1246,175,14010,164,4825865,7.527377,61.689181,1816,625829
172.69.223.155,41522,167.235.145.223,443,289,4589402,2142,130,10958,159,4578444,22.849498,30.872057,2839,1186430
172.69.223.156,15120,167.235.145.223,443,235,2303278,2149,115,9110,120,2294168,22.93994,60.06202,1213,305573
172.69.223.157,44108,167.235.145.223,443,543,11828696,3290,257,21970,286,11806726,65.192065,10.94248,16062,8631846
172.69.223.161,39668,167.235.145.223,443,316,4831231,574,149,12682,167,4818549,1.084167,61.815607,1641,623602
172.69.223.164,43516,167.235.145.223,443,453,4008130,1517,206,16881,247,3991249,11.86555,61.835356,2183,516371
172.69.223.167,17704,167.235.145.223,443,48,1188854,759,24,2362,24,1186492,1.711043,60.014842,314,158159
172.69.223.169,18028,167.235.145.223,443,6,427,171,2,132,4,295,0.283576,29.92268,35,78
172.69.223.169,27702,167.235.145.223,443,163,1313109,3263,73,6337,90,1306772,63.764389,0.156625,323677,66746534
172.69.223.172,23366,167.235.145.223,443,109,2054885,568,39,3561,70,2051324,1.068314,60.016338,474,273435
172.69.223.193,14824,167.235.145.223,443,226,1251006,2091,110,8779,116,1242227,21.698078,60.058519,1169,165468
172.69.244.131,55398,167.235.145.223,443,734,4938986,1715,170,12883,564,4926103,15.195014,55.369189,1861,711746
172.69.244.137,10362,167.235.145.223,443,2250,6931988,2073,937,64977,1313,6867011,21.204257,37.330522,13924,1471613
172.69.244.138,14208,167.235.145.223,443,462,4420557,911,119,15278,343,4405279,2.759668,61.573261,1985,572362
172.69.244.144,40938,167.235.145.223,443,344,2070251,941,87,6584,257,2063667,3.201451,60.210564,874,274193
172.69.244.145,46102,167.235.145.223,443,7,493,2086,3,198,4,295,21.506296,29.906824,52,78
172.69.244.151,27482,167.235.145.223,443,638,11662071,970,280,26658,358,11635413,3.627942,78.714107,2709,1182549
172.69.244.155,11364,167.235.145.223,443,27,16743,1385,18,8406,9,8337,9.636426,72.23098,931,923
172.69.244.164,33488,167.235.145.223,443,7,493,1740,3,198,4,295,15.834566,29.573091,53,79
172.69.244.165,58756,167.235.145.223,443,1685,2775537,3515,758,51500,927,2724037,76.112426,2.815049,146356,7741355
172.70.34.25,12452,167.235.145.223,443,23,11642,1884,12,3852,11,7790,18.228687,56.06503,549,1111
172.70.34.41,52648,167.235.145.223,443,628,2473867,3381,273,19604,355,2454263,68.714389,1.136417,138005,17277200
172.70.34.74,46110,167.235.145.223,443,596,2067986,2890,268,19274,328,2048712,44.638896,31.16847,4947,525842
172.70.34.80,60468,167.235.145.223,443,598,2092243,915,268,19274,330,2072969,2.79995,60.418618,2552,274480
172.70.34.81,27036,167.235.145.223,443,645,2212829,3608,300,21386,345,2191443,80.619027,1.130641,151319,15505844
172.70.34.89,40982,167.235.145.223,443,7,493,979,3,198,4,295,3.730187,29.29139,54,80
172.70.34.109,12932,167.235.145.223,443,645,2453904,3138,294,20990,351,2432914,56.814343,1.132021,148336,17193419
172.70.34.118,35924,167.235.145.223,443,673,2708859,3502,312,22178,361,2686681,74.616872,1.133536,156522,18961416
172.70.34.154,31814,167.235.145.223,443,675,2193724,3252,324,22970,351,2170754,62.703586,1.135292,161861,15296533
172.70.34.175,26284,167.235.145.223,443,728,4636626,1339,320,23641,408,4612985,8.655228,72.027155,2625,512360
172.70.34.185,13298,167.235.145.223,443,6,427,2454,2,132,4,295,27.743732,29.240714,36,80
172.70.34.201,61276,167.235.145.223,443,1273,2868347,3010,568,41694,705,2826653,50.614766,31.463953,10601,718702
172.70.34.210,44246,167.235.145.223,443,6,427,1748,2,132,4,295,15.987996,29.259654,36,80
172.70.34.216,58314,167.235.145.223,443,127,2116267,2095,58,4763,69,2111504,21.763454,47.423013,803,356199
172.70.34.254,56498,167.235.145.223,443,42,27643,871,28,14672,14,12971,2.339101,78.141851,1502,1327
172.70.35.27,49074,167.235.145.223,443,630,2519206,2643,266,19142,364,2500064,32.729221,31.249776,4900,640020
172.70.35.35,52184,167.235.145.223,443,663,2512391,1701,301,21452,362,2490939,14.732321,60.422988,2840,329800
172.70.35.90,15184,167.235.145.223,443,7,493,1393,3,198,4,295,9.898628,29.251185,54,80
172.70.35.91,51246,167.235.145.223,443,594,2327007,2409,248,17954,346,2309053,26.578648,31.160408,4609,592817
172.70.46.3,55998,167.235.145.223,443,215,2328929,857,103,8188,112,2320741,2.243274,60.050693,1090,309170
172.70.46.5,24300,167.235.145.223,443,342,7245793,3051,157,13308,185,7232485,53.035911,1.295093,82205,44676235
172.70.46.5,46374,167.235.145.223,443,6,427,1383,2,132,4,295,9.597185,29.934803,35,78
172.70.46.6,15370,167.235.145.223,443,7,493,1826,3,198,4,295,17.258545,29.996552,52,78
172.70.46.7,41994,167.235.145.223,443,188,2780562,3091,87,7921,101,2772641,54.344556,1.533241,41329,14466824
172.70.46.10,54908,167.235.145.223,443,353,7445394,2524,162,13638,191,7431756,29.089896,31.048845,3513,1914855
172.70.46.12,32638,167.235.145.223,443,211,2462420,186,128,48477,83,2413943,0.301577,78.636685,4931,245579
172.70.46.12,46790,167.235.145.223,443,32,17477,3310,18,6902,14,10575,65.613288,13.609667,4057,6216
172.70.46.19,46280,167.235.145.223,443,202,2316042,3625,95,7723,107,2308319,81.671505,0.115415,535320,160001316
172.70.46.20,14054,167.235.145.223,443,117,74926,541,78,38725,39,36201,1.007365,80.546303,3846,3595
172.70.46.21,32274,167.235.145.223,443,114,72383,841,76,37181,38,35202,2.151644,79.36835,3747,3548
172.70.46.22,14138,167.235.145.223,443,36,22680,1266,24,11562,12,11118,7.733486,75.287314,1228,1181
172.70.46.23,9858,167.235.145.223,443,107,2335621,767,60,14003,47,2321618,1.728197,81.185062,1379,228772
172.70.46.26,51830,167.235.145.223,443,361,7310349,3287,173,14411,188,7295938,65.179503,1.372233,84014,42534689
172.70.46.33,52620,167.235.145.223,443,380,8007668,3421,177,14675,203,7992993,71.218908,1.451439,80885,44055550
172.70.46.39,59712,167.235.145.223,443,222,6862144,2160,113,9753,109,6852391,23.040773,31.143156,2505,1760230
172.70.46.40,30908,167.235.145.223,443,192,2901243,3458,87,7844,105,2893399,72.380871,0.717757,87427,32249343
172.70.46.46,13396,167.235.145.223,443,6,427,1494,2,132,4,295,11.454053,29.875855,35,78
172.70.46.50,30906,167.235.145.223,443,218,4854571,853,118,30858,100,4823713,2.219383,78.09447,3161,494141
172.70.46.51,55736,167.235.145.223,443,305,2531213,770,168,35555,137,2495658,1.756923,79.880345,3560,249939
172.70.46.55,39926,167.235.145.223,443,208,2385767,3391,98,7921,110,2377846,69.641637,0.158716,399254,119854129
172.70.46.59,52974,167.235.145.223,443,292,6094443,2801,127,11328,165,6083115,41.075948,31.451997,2881,1547275
172.70.46.64,65064,167.235.145.223,443,186,2082964,3149,86,7129,100,2075835,57.616617,0.114003,500267,145668798
172.70.46.84,30890,167.235.145.223,443,78,46670,952,52,22584,26,24086,3.390837,78.28412,2307,2461
172.70.46.85,39200,167.235.145.223,443,142,2416870,332,80,25088,62,2391782,0.561535,80.923559,2480,236448
172.70.46.90,13992,167.235.145.223,443,6,427,1281,2,132,4,295,7.861858,29.981126,35,78
172.70.46.104,53886,167.235.145.223,443,273,9221619,2451,128,12254,145,9209365,27.720187,51.209633,1914,1438692
172.70.46.104,53892,167.235.145.223,443,7,493,1095,3,198,4,295,5.224094,29.931398,52,78
172.70.46.105,29022,167.235.145.223,443,7,493,1090,3,198,4,295,5.192174,29.902603,52,78
172.70.46.108,56386,167.235.145.223,443,126,2274158,530,72,20727,54,2253431,0.987969,79.066488,2097,228003
172.70.46.109,43334,167.235.145.223,443,172,4231764,660,89,22480,83,4209284,1.358288,81.681917,2201,412261
172.70.46.120,39676,167.235.145.223,443,67,2054937,2087,31,2848,36,2052089,21.550471,60.014474,379,273545
172.70.46.140,37416,167.235.145.223,443,126,78524,573,84,39606,42,38918,1.081634,80.461657,3937,3869
172.70.46.141,45082,167.235.145.223,443,126,77393,318,84,38486,42,38907,0.532985,80.286529,3834,3876
172.70.46.142,27714,167.235.145.223,443,6,427,752,2,132,4,295,1.673382,29.995865,35,78
172.70.46.148,61086,167.235.145.223,443,183,2882669,2590,80,7450,103,2875219,30.309076,30.906261,1928,744242
172.70.46.153,60992,167.235.145.223,443,181,2665587,1545,79,7384,102,2658203,12.304262,60.833745,971,349569
172.70.46.154,16040,167.235.145.223,443,6,427,2097,2,132,4,295,21.839698,29.707243,35,79
172.70.46.158,44258,167.235.145.223,443,265,5285122,1889,125,11222,140,5273900,18.31681,39.471205,2274,1068910
172.70.46.161,33758,167.235.145.223,443,191,2423838,1379,77,6535,114,2417303,9.553857,60.053135,870,322021
172.70.46.165,43506,167.235.145.223,443,132,81323,792,88,40550,44,40773,1.869695,79.796482,4065,4087
172.70.46.165,49422,167.235.145.223,443,135,84767,730,90,42993,45,41774,1.587927,80.576598,4268,4147
172.70.46.167,21218,167.235.145.223,443,108,64811,18,72,31463,36,33348,0.016918,79.455801,3167,3357
172.70.46.167,25588,167.235.145.223,443,105,63717,74,70,31296,35,32421,0.119058,79.19654,3161,3274
172.70.46.187,17154,167.235.145.223,443,135,1142457,3636,64,5678,71,1136779,82.388129,0.109376,415301,83146503
172.70.46.195,36750,167.235.145.223,443,215,2595500,3331,107,9241,108,2586259,66.327008,1.568193,47142,13193575
172.70.46.197,30242,167.235.145.223,443,196,2355365,372,124,35753,72,2319612,0.647271,79.945126,3577,232120
172.70.46.197,36142,167.235.145.223,443,108,65373,459,72,32017,36,33356,0.807731,80.952334,3164,3296
172.70.46.202,18150,167.235.145.223,443,6,427,1989,2,132,4,295,19.849229,29.993684,35,78
172.70.46.206,27946,167.235.145.223,443,346,6459578,3161,167,13970,179,6445608,58.211265,2.25209,49625,22896449
172.70.46.211,43406,167.235.145.223,443,206,2474385,1172,100,8779,106,2465606,6.304327,61.539156,1141,320525
172.70.46.212,28246,167.235.145.223,443,138,1271894,445,86,33961,52,1237933,0.788433,80.777153,3363,122602
172.70.46.212,62636,167.235.145.223,443,105,66276,47,70,33704,35,32572,0.071712,82.727729,3259,3149
172.70.46.213,26432,167.235.145.223,443,140,1076322,176,91,34212,49,1042110,0.289494,80.958629,3380,102977
172.70.46.223,38520,167.235.145.223,443,180,1769122,2637,88,7198,92,1761924,32.308212,30.350093,1897,464426
172.70.46.229,46200,167.235.145.223,443,171,2466019,2249,78,7318,93,2458701,24.326249,30.930154,1892,635936
172.70.46.235,29492,167.235.145.223,443,173,2454051,3565,81,7448,92,2446603,77.890234,0.470759,126570,41577163
172.70.46.237,15960,167.235.145.223,443,604,7741321,2689,284,23504,320,7717817,35.028157,31.338667,5999,1970171
172.70.46.239,27428,167.235.145.223,443,478,7827432,1759,219,18110,259,7809322,16.268225,61.570842,2353,1014677
172.70.46.245,17514,167.235.145.223,443,196,2131870,1730,92,7525,104,2124345,15.549786,60.052162,1002,282999
172.70.46.250,51240,167.235.145.223,443,66,41311,926,44,20930,22,20381,2.923514,78.089513,2144,2087
172.70.46.250,57250,167.235.145.223,443,69,42994,474,46,21644,23,21350,0.839588,81.534244,2123,2094
172.70.47.13,39730,167.235.145.223,443,63,37909,623,42,18451,21,19458,1.242831,78.025213,1891,1995
172.70.47.18,17368,167.235.145.223,443,105,62372,162,70,29953,35,32419,0.263324,78.694654,3044,3295
172.70.47.18,32820,167.235.145.223,443,105,62754,343,70,30332,35,32422,0.578039,78.381904,3095,3309
172.70.47.23,24364,167.235.145.223,443,351,7779760,2923,148,12714,203,7767046,47.019759,31.601678,3218,1966236
172.70.47.27,48228,167.235.145.223,443,132,4467940,1734,58,6820,74,4461120,15.747121,46.125924,1182,773728
172.70.47.38,17620,167.235.145.223,443,190,2122489,2779,90,7463,100,2115026,39.509144,30.119899,1982,561761
172.70.47.39,9872,167.235.145.223,443,206,2222850,3006,100,7990,106,2214860,50.334546,30.116382,2122,588346
172.70.47.51,64392,167.235.145.223,443,87,53576,563,58,26713,29,26863,1.062267,79.679678,2682,2697
172.70.47.52,59902,167.235.145.223,443,87,52325,740,58,25458,29,26867,1.626926,80.209298,2539,2679
172.70.47.56,54268,167.235.145.223,443,48,30011,732,32,15191,16,14820,1.598429,78.168109,1554,1516
172.70.47.56,61512,167.235.145.223,443,45,28388,765,30,14493,15,13895,1.718644,77.969253,1487,1425
172.70.85.4,44224,167.235.145.223,443,6,427,2300,2,132,4,295,25.194706,29.982335,35,78
172.70.85.4,56876,167.235.145.223,443,250,2186645,3551,114,8996,136,2177649,77.23063,0.237018,303639,73501556
172.70.85.23,43492,167.235.145.223,443,217,1247208,1695,104,8187,113,1239021,14.644291,60.101228,1089,164924
172.70.85.28,28040,167.235.145.223,443,253,2256203,1096,108,8600,145,2247603,5.228536,60.103004,1144,299166
172.70.85.30,31900,167.235.145.223,443,266,2305245,2183,127,9854,139,2295391,23.214452,30.247467,2606,607096
172.70.85.60,26470,167.235.145.223,443,6,427,1928,2,132,4,295,19.197956,29.963065,35,78
172.70.85.62,44060,167.235.145.223,443,223,1344034,2068,106,8319,117,1335715,21.021872,60.101689,1107,177794
172.70.85.83,27830,167.235.145.223,443,7,493,1342,3,198,4,295,8.669103,29.952406,52,78
172.70.85.107,34752,167.235.145.223,443,6,427,254,2,132,4,295,0.41937,29.866278,35,79
172.70.85.112,64696,167.235.145.223,443,217,1373745,3139,106,8319,111,1365426,56.843601,0.228383,291405,47829339
172.70.85.114,58128,167.235.145.223,443,7,493,1223,3,198,4,295,7.241347,29.91841,52,78
172.70.85.124,41852,167.235.145.223,443,269,2166814,3187,129,9986,140,2156828,59.236064,0.287198,278163,60079192
172.70.85.136,35324,167.235.145.223,443,193,1305869,3506,85,6933,108,1298936,74.994715,0.214208,258925,48511204
172.70.85.142,53790,167.235.145.223,443,240,2358928,1344,115,9585,125,2349343,8.759355,66.278919,1156,283570
172.70.85.157,49670,167.235.145.223,443,10,2289,564,5,1067,5,1222,1.063205,60.022361,142,162
172.70.85.165,36138,167.235.145.223,443,208,1400281,3253,98,7791,110,1392490,62.731161,0.225225,276736,49461294
172.70.85.167,34646,167.235.145.223,443,296,2488055,1480,143,10910,153,2477145,11.228055,60.097868,1452,329748
172.70.85.203,32350,167.235.145.223,443,264,2371436,1823,116,9128,148,2362308,17.212241,60.096426,1215,314469
172.70.85.209,33534,167.235.145.223,443,61,2051486,604,24,2340,37,2049146,1.171336,60.025574,311,273103
172.70.85.229,10054,167.235.145.223,443,42,26271,141,28,13300,14,12971,0.228387,78.049762,1363,1329
172.70.85.231,51102,167.235.145.223,443,217,1346646,921,102,8055,115,1338591,2.867177,60.100469,1072,178180
172.70.85.239,45450,167.235.145.223,443,260,2606171,2946,110,8732,150,2597439,47.220031,30.48886,2291,681544
172.70.85.241,35204,167.235.145.223,443,222,1461452,3612,106,8319,116,1453133,80.886167,0.225309,295381,51596092
172.70.85.244,38684,167.235.145.223,443,252,2129538,2697,115,9062,137,2120476,35.220734,30.250816,2396,560771
172.70.85.247,16532,167.235.145.223,443,209,1270771,2422,100,7923,109,1262848,26.911091,30.263418,2094,333828
172.70.86.22,13150,167.235.145.223,443,71,2028088,2434,35,3131,36,2024957,27.199146,44.512101,562,363938
172.70.86.28,56006,167.235.145.223,443,266,2449861,3298,122,9524,144,2440337,65.235381,0.237238,321162,82291605
172.70.86.31,51052,167.235.145.223,443,42,24760,855,28,11790,14,12970,2.235857,76.079978,1239,1363
172.70.86.31,64610,167.235.145.223,443,115,2436302,189,63,15561,52,2420741,0.305105,79.978504,1556,242139
172.70.86.55,27408,167.235.145.223,443,6,427,2069,2,132,4,295,21.028528,29.682981,35,79
172.70.86.58,64870,167.235.145.223,443,214,1243971,2644,103,8121,111,1235850,32.805043,30.226645,2149,327088
172.70.86.73,48286,167.235.145.223,443,6,427,1588,2,132,4,295,13.190458,29.97715,35,78
172.70.86.91,26670,167.235.145.223,443,6,427,1175,2,132,4,295,6.437282,29.873201,35,79
172.70.86.127,12684,167.235.145.223,443,42,26716,603,28,13748,14,12968,1.16913,78.01022,1409,1329
172.70.86.130,28956,167.235.145.223,443,39,24184,1086,26,12142,13,12042,5.161065,72.029769,1348,1337
172.70.86.131,39008,167.235.145.223,443,292,2683599,3428,141,10778,151,2672821,71.33454,0.234609,367522,91141294
172.70.86.154,10030,167.235.145.223,443,173,1223188,3012,73,6141,100,1217047,50.953983,30.219603,1625,322187
172.70.86.156,20868,167.235.145.223,443,196,1095130,3378,90,7263,106,1087867,68.61794,0.227338,255584,38281923
172.70.86.159,61450,167.235.145.223,443,226,1452692,2769,109,8517,117,1444175,38.688925,30.241385,2253,382039
172.70.86.177,50416,167.235.145.223,443,287,2496454,2540,137,10514,150,2485940,29.230449,30.261199,2779,657195
172.70.90.5,43568,167.235.145.223,443,42,26908,983,28,13930,14,12978,3.771441,78.088079,1427,1329
172.70.90.15,58046,167.235.145.223,443,247,1773687,2657,122,9585,125,1764102,33.872387,30.231245,2536,466828
172.70.90.31,48120,167.235.145.223,443,246,2126195,2782,111,8859,135,2117336,39.869208,30.413651,2330,556943
172.70.90.31,62562,167.235.145.223,443,6,427,1005,2,132,4,295,4.23372,29.654042,35,79
172.70.90.35,22882,167.235.145.223,443,252,2045226,2864,115,9119,137,2036107,43.470913,30.398014,2399,535852
172.70.90.42,55506,167.235.145.223,443,79,2209475,2341,41,3588,38,2205887,25.708583,56.264119,510,313647
172.70.90.111,21044,167.235.145.223,443,42,26843,673,28,13874,14,12969,1.412616,78.028962,1422,1329
172.70.90.116,53116,167.235.145.223,443,254,2388883,3394,112,8925,142,2379958,69.880114,0.279179,255749,68198768
172.70.90.129,65358,167.235.145.223,443,346,4897526,2986,158,12839,188,4884687,49.47134,26.437203,3885,1478125
172.70.90.141,63676,167.235.145.223,443,250,2087268,3155,117,9255,133,2078013,57.874962,0.259753,285040,63999661
172.70.90.144,25032,167.235.145.223,443,7,493,1758,3,198,4,295,16.237212,29.661542,53,79
172.70.90.151,62356,167.235.145.223,443,294,2487980,1606,144,11033,150,2476947,13.454473,60.091519,1468,329756
172.70.90.169,22582,167.235.145.223,443,7,493,1264,3,198,4,295,7.715291,29.839133,53,79
172.70.90.173,52126,167.235.145.223,443,247,2186504,3581,113,8987,134,2177517,79.465668,0.243034,295826,71677773
172.70.90.195,53106,167.235.145.223,443,287,2451303,3352,139,10703,148,2440600,67.469387,0.251022,341101,77781230
172.70.90.207,26458,167.235.145.223,443,6,427,1974,2,132,4,295,19.719537,29.846099,35,79
172.70.90.219,58616,167.235.145.223,443,329,4384148,690,154,12575,175,4371573,1.457239,62.386824,1612,560576
172.70.90.248,59752,167.235.145.223,443,326,4703351,2903,150,12315,176,4691036,45.878506,18.031878,5463,2081219
172.70.90.249,25034,167.235.145.223,443,6,427,1406,2,132,4,295,10.275173,29.610686,35,79
172.70.90.253,27644,167.235.145.223,443,6,427,761,2,132,4,295,1.712612,29.840799,35,79
172.70.91.3,21612,167.235.145.223,443,333,4782157,1947,152,12439,181,4769718,19.462913,36.056759,2759,1058268
172.70.91.5,42566,167.235.145.223,443,262,2166409,3230,123,9647,139,2156762,61.472695,0.250149,308520,68975274
172.70.91.56,12940,167.235.145.223,443,264,2305169,2319,123,9647,141,2295522,25.464972,30.246489,2551,607150
172.70.91.90,36604,167.235.145.223,443,284,2782599,2457,126,9849,158,2772750,27.868636,30.345853,2596,730973
172.70.91.95,45516,167.235.145.223,443,281,2682930,3477,130,10109,151,2672821,73.491942,0.246046,328686,86904757
172.70.91.98,61256,167.235.145.223,443,270,2320610,3628,129,10047,141,2310563,81.887484,0.237324,338676,77887209
172.70.91.99,14550,167.235.145.223,443,278,2257910,1242,131,10175,147,2247735,7.455188,60.096477,1354,299216
172.70.91.144,61264,167.235.145.223,443,71,2410862,1392,28,2730,43,2408132,9.836691,60.024229,363,320954
172.70.91.148,60084,167.235.145.223,443,274,2137098,1741,131,10179,143,2126919,15.850898,60.102341,1354,283106
172.70.91.165,59372,167.235.145.223,443,6,427,1642,2,132,4,295,13.749182,29.820535,35,79
172.70.91.188,61710,167.235.145.223,443,251,2072296,2100,113,8991,138,2063305,21.857331,60.093314,1196,274680
172.70.91.203,41522,167.235.145.223,443,293,2496907,2617,140,10769,153,2486138,31.478915,30.50023,2824,652096
172.70.91.213,62054,167.235.145.223,443,6,427,2104,2,132,4,295,22.056781,29.845807,35,79
172.70.91.233,9852,167.235.145.223,443,6,427,2468,2,132,4,295,28.135242,29.778747,35,79
172.70.91.240,27128,167.235.145.223,443,265,2130453,2737,131,10175,134,2120278,37.471176,30.310118,2685,559622
172.70.92.137,49818,167.235.145.223,443,635,1271900,2276,292,20738,343,1251162,24.836925,31.568371,5255,317067
172.70.92.140,44782,167.235.145.223,443,681,1338220,3339,319,22520,362,1315700,66.89143,1.66511,108197,6321264
172.70.92.151,26218,167.235.145.223,443,771,2643981,2823,321,23089,450,2620892,41.444453,12.325917,14985,1701060
172.70.92.153,11936,167.235.145.223,443,168,2474276,1554,51,3992,117,2470284,12.530666,60.159111,530,328500
172.70.92.169,14502,167.235.145.223,443,6,427,903,2,132,4,295,2.662238,28.951574,36,81
172.70.92.184,13080,167.235.145.223,443,6,427,1341,2,132,4,295,8.668153,28.949155,36,81
172.70.92.194,64512,167.235.145.223,443,7,493,2437,3,198,4,295,27.226356,28.675641,55,82
172.70.92.197,29666,167.235.145.223,443,7,493,2395,3,198,4,295,26.371936,28.841675,54,81
172.70.92.198,38634,167.235.145.223,443,660,1234419,480,315,22256,345,1212163,0.854013,60.68562,2933,159795
172.70.92.200,48152,167.235.145.223,443,596,1196829,2703,267,18899,329,1177930,35.439204,31.672365,4773,297528
172.70.92.238,22008,167.235.145.223,443,6,427,2033,2,132,4,295,20.478786,29.00422,36,81
172.70.92.244,29184,167.235.145.223,443,603,1121946,3195,291,20483,312,1101463,59.495058,1.555479,105346,5664945
172.70.92.252,56084,167.235.145.223,443,6,427,2024,2,132,4,295,20.296516,28.858313,36,81
172.70.93.31,24608,167.235.145.223,443,693,1302889,1906,334,23510,359,1279379,18.859136,60.664572,3100,168715
172.70.93.32,52832,167.235.145.223,443,866,2109622,313,410,28337,456,2081285,0.523475,60.641892,3738,274567
172.70.93.53,38222,167.235.145.223,443,692,1483402,2556,314,22001,378,1461401,29.425899,31.633986,5563,369577
172.70.147.34,23926,167.235.145.223,443,6,427,1333,2,132,4,295,8.516951,28.744888,36,82
172.70.147.52,10468,167.235.145.223,443,6,427,1683,2,132,4,295,14.329611,28.839892,36,81
172.70.147.74,18666,167.235.145.223,443,7,493,1684,3,198,4,295,14.444665,29.014351,54,81
172.70.147.78,14704,167.235.145.223,443,6,427,850,2,132,4,295,2.2153,28.896766,36,81
172.70.147.96,17238,167.235.145.223,443,941,2301416,1181,439,30251,502,2271165,6.547294,60.741384,3984,299125
172.70.147.107,56666,167.235.145.223,443,42,26215,852,28,13244,14,12971,2.217933,78.159759,1355,1327
172.70.147.128,22960,167.235.145.223,443,642,1266346,3578,303,21464,339,1244882,78.904089,1.579056,108743,6306968
172.70.147.137,35832,167.235.145.223,443,712,1467871,3464,349,24500,363,1443371,72.823168,1.568466,124962,7361949
172.70.147.138,17622,167.235.145.223,443,705,1375989,1571,333,23444,372,1352545,12.838748,60.682869,3090,178309
172.70.147.149,36046,167.235.145.223,443,554,1269593,1201,193,14204,361,1255389,6.822017,60.723287,1871,165391
172.70.147.153,47754,167.235.145.223,443,42,25961,231,28,12992,14,12969,0.37833,78.185183,1329,1327
172.70.147.167,63878,167.235.145.223,443,740,1408217,2953,355,24707,385,1383510,47.462541,31.81842,6211,347851
172.70.147.195,33374,167.235.145.223,443,46,25054,68,31,11151,15,13903,0.111366,82.662643,1079,1345
172.70.210.3,21806,167.235.145.223,443,617,1123047,3249,296,20990,321,1102057,62.307788,1.590936,105547,5541678
172.70.210.3,65296,167.235.145.223,443,6,427,1041,2,132,4,295,4.915311,29.01312,36,81
172.70.210.23,51702,167.235.145.223,443,141,1237187,1525,42,3575,99,1233612,11.987315,60.162817,475,164036
172.70.210.70,44356,167.235.145.223,443,746,1496167,3499,358,25082,388,1471085,74.300207,1.594443,125847,7381060
172.70.210.88,13172,167.235.145.223,443,6,427,1451,2,132,4,295,10.961923,28.974676,36,81
172.70.210.164,44274,167.235.145.223,443,680,1256780,2886,324,22838,356,1233942,44.304579,31.617412,5778,312218
172.70.210.188,39126,167.235.145.223,443,7,493,2440,3,198,4,295,27.271032,29.783488,53,79
172.70.210.200,61742,167.235.145.223,443,640,1299379,1800,297,21056,343,1278323,16.94306,60.630971,2778,168669
172.70.211.25,9058,167.235.145.223,443,719,1479569,2512,344,24158,375,1455411,28.923292,31.681614,6100,367509
172.70.211.58,12040,167.235.145.223,443,655,1336492,3375,304,21518,351,1314974,68.305795,1.556676,110584,6757855
172.70.211.77,24878,167.235.145.223,443,689,1374920,1584,329,23168,360,1351752,13.138879,60.627632,3057,178367
172.70.211.94,18924,167.235.145.223,443,659,1234341,1387,319,22508,340,1211833,9.681384,60.65816,2968,159824
172.70.211.103,21916,167.235.145.223,443,658,1201098,2687,319,22508,339,1178590,34.957664,31.620449,5694,298184
172.70.211.121,25140,167.235.145.223,443,706,1406150,3005,337,23696,369,1382454,50.31028,31.624814,5994,349713
172.70.211.123,18312,167.235.145.223,443,664,1267786,3600,317,22376,347,1245410,80.286956,1.591882,112450,6258805
172.70.211.140,52318,167.235.145.223,443,705,1433214,3132,345,24224,360,1408990,56.386643,1.575828,122977,7153014
172.70.211.151,52008,167.235.145.223,443,664,1273801,2151,314,22178,350,1251623,22.951198,31.652911,5605,316336
172.70.211.166,21118,167.235.145.223,443,709,1379249,1188,333,23432,376,1355817,6.639338,60.659177,3090,178811
172.70.211.206,20796,167.235.145.223,443,44,25933,86,29,12890,15,13043,0.131984,79.94269,1289,1305
172.70.211.220,20850,167.235.145.223,443,6,427,1797,2,132,4,295,16.904778,29.01066,36,81
172.70.235.130,14216,167.235.145.223,443,593,2411069,3401,332,23257,261,2387812,70.556614,0.653697,284621,29222248
172.70.235.132,27974,167.235.145.223,443,253,8854047,1422,114,10300,139,8843747,10.647203,71.978562,1144,982931
172.70.235.135,65370,167.235.145.223,443,679,4873925,2487,358,25667,321,4848258,28.540485,30.093176,6823,1288865
172.70.235.137,37198,167.235.145.223,443,168,4687411,2546,92,7460,76,4679951,29.254382,35.730396,1670,1047836
172.70.235.138,55858,167.235.145.223,443,151,5980322,1777,57,5844,94,5974478,16.548125,54.424184,859,878209
172.70.235.140,25296,167.235.145.223,443,96,2337370,1013,46,13180,50,2324190,4.450836,78.079692,1350,238135
172.70.235.142,62890,167.235.145.223,443,74,2410872,1416,33,2872,41,2408000,10.539697,60.064051,382,320724
172.70.242.10,58840,167.235.145.223,443,242,5539725,2146,116,10662,126,5529063,22.921486,36.266127,2351,1219664
172.70.242.15,45020,167.235.145.223,443,152,2519060,1828,69,6728,83,2512332,17.259622,61.55917,874,326493
172.70.242.19,10888,167.235.145.223,443,6,427,1397,2,132,4,295,10.039305,29.758132,35,79
172.70.242.21,46328,167.235.145.223,443,6,427,16,2,132,4,295,0.015805,29.879046,35,78
172.70.242.28,32752,167.235.145.223,443,278,6025659,3140,139,12972,139,6012687,57.170766,22.911573,4529,2099441
172.70.242.38,26566,167.235.145.223,443,239,4121860,1920,118,9995,121,4111865,19.074075,63.208437,1265,520419
172.70.242.50,39946,167.235.145.223,443,7,493,1001,3,198,4,295,4.122191,29.990433,52,78
172.70.242.53,39122,167.235.145.223,443,6,427,1746,2,132,4,295,15.950379,29.992049,35,78
172.70.242.56,30484,167.235.145.223,443,150,2470750,1220,69,6794,81,2463956,7.145941,64.14853,847,307281
172.70.242.60,42700,167.235.145.223,443,7,493,2178,3,198,4,295,23.169926,28.770872,55,82
172.70.242.75,53636,167.235.145.223,443,6,427,2211,2,132,4,295,23.543844,29.716083,35,79
172.70.242.78,62508,167.235.145.223,443,253,4876159,3288,118,10068,135,4866091,65.186322,2.068578,38936,18819076
172.70.242.92,64130,167.235.145.223,443,247,4755196,3342,112,9599,135,4745597,67.078601,4.445727,17273,8539610
172.70.242.104,27488,167.235.145.223,443,6,427,2535,2,132,4,295,29.19976,29.922605,35,78
172.70.242.123,17444,167.235.145.223,443,6,427,1321,2,132,4,295,8.357342,29.845178,35,79
172.70.242.132,57798,167.235.145.223,443,258,4834277,1214,121,10193,137,4824084,7.090146,62.793323,1298,614598
172.70.242.137,38488,167.235.145.223,443,38,22789,2596,23,9568,15,13221,30.703702,48.019546,1594,2202
172.70.242.137,58132,167.235.145.223,443,75,46485,370,50,23331,25,23154,0.637736,78.984047,2363,2345
172.70.242.139,46776,167.235.145.223,443,42,26829,617,28,13860,14,12969,1.227932,78.10415,1419,1328
172.70.242.140,19646,167.235.145.223,443,105,62936,510,70,30515,35,32421,0.943113,79.623188,3065,3257
172.70.242.140,22982,167.235.145.223,443,105,62959,789,70,30534,35,32425,1.85102,79.174416,3085,3276
172.70.242.142,47764,167.235.145.223,443,132,84463,195,88,43692,44,40771,0.314554,81.77315,4274,3988
172.70.242.145,53210,167.235.145.223,443,45,25552,569,30,11659,15,13893,1.069096,78.10068,1194,1423
172.70.242.146,42348,167.235.145.223,443,84,50514,712,56,24576,28,25938,1.533959,78.165372,2515,2654
172.70.242.147,25182,167.235.145.223,443,87,55055,497,58,28194,29,26861,0.905625,80.708991,2794,2662
172.70.242.148,29140,167.235.145.223,443,96,58627,699,64,28986,32,29641,1.504235,79.025624,2934,3000
172.70.242.153,45440,167.235.145.223,443,142,1252373,648,89,34739,53,1217634,1.324654,78.740873,3529,123710
172.70.242.154,44190,167.235.145.223,443,107,2135575,606,60,16485,47,2119090,1.172618,78.032809,1690,217251
172.70.242.154,47100,167.235.145.223,443,103,2132171,868,56,13083,47,2119088,2.298034,78.065459,1340,217160
172.70.242.161,63900,167.235.145.223,443,168,6561992,1396,65,6879,103,6555113,10.008574,63.248776,870,829121
172.70.242.164,12076,167.235.145.223,443,159,2591852,3380,78,7375,81,2584477,68.705897,0.557752,105781,37069909
172.70.242.179,30980,167.235.145.223,443,6,427,1824,2,132,4,295,17.244558,29.791144,35,79
172.70.242.183,60192,167.235.145.223,443,7,493,2102,3,198,4,295,21.9674,29.987413,52,78
172.70.242.188,32508,167.235.145.223,443,6,427,1761,2,132,4,295,16.291112,29.582059,35,79
172.70.242.193,31310,167.235.145.223,443,148,2452527,3597,70,6847,78,2445680,80.139619,1.102564,49680,17745400
172.70.242.195,41442,167.235.145.223,443,305,5800219,565,153,13265,152,5786954,1.065307,75.942336,1397,609615
172.70.242.207,16276,167.235.145.223,443,124,1325727,1044,62,5703,62,1320024,4.924689,60.031748,759,175910
172.70.242.212,18630,167.235.145.223,443,46,1348589,1442,21,2346,25,1346243,10.918264,60.008158,312,179474
172.70.242.219,9978,167.235.145.223,443,130,1340936,1109,66,5711,64,1335225,5.332592,60.028839,761,177944
172.70.242.227,56438,167.235.145.223,443,156,2465073,2190,78,7361,78,2457712,23.260402,43.047025,1367,456749
172.70.243.13,55984,167.235.145.223,443,261,2183385,1033,148,36218,113,2147167,4.806475,76.292297,3797,225151
172.70.243.14,58552,167.235.145.223,443,153,2175576,613,89,31628,64,2143948,1.197827,79.889464,3167,214691
172.70.243.15,55998,167.235.145.223,443,105,64567,581,70,31996,35,32571,1.09811,79.154539,3233,3291
172.70.243.16,50810,167.235.145.223,443,105,65351,600,70,32926,35,32425,1.163647,79.501593,3313,3262
172.70.243.17,38050,167.235.145.223,443,153,1062451,800,97,41291,56,1021160,1.899397,79.945884,4131,102185
172.70.243.19,23112,167.235.145.223,443,44,25177,966,26,9966,18,15211,3.581757,70.560576,1129,1724
172.70.243.19,23124,167.235.145.223,443,42,23469,969,25,9257,17,14212,3.599481,76.485956,968,1486
172.70.243.20,47988,167.235.145.223,443,45,25274,967,27,10064,18,15210,3.584325,76.513899,1052,1590
172.70.243.21,34776,167.235.145.223,443,72,45756,741,48,23524,24,22232,1.629486,79.341471,2371,2241
172.70.243.22,34398,167.235.145.223,443,69,44119,719,46,22814,23,21305,1.567338,78.177527,2334,2180
172.70.243.24,10832,167.235.145.223,443,87,51741,892,58,25100,29,26641,2.576088,74.911639,2680,2845
172.70.243.31,36518,167.235.145.223,443,329,7492320,2940,149,13074,180,7479246,47.168984,34.038575,3072,1757828
172.70.243.39,36850,167.235.145.223,443,257,4352103,3546,127,10662,130,4341441,77.18583,2.062966,41346,16835724
172.70.243.43,11946,167.235.145.223,443,394,11612733,2207,155,15076,239,11597657,23.49347,53.549508,2252,1732625
172.70.243.48,62962,167.235.145.223,443,159,2579798,1131,76,7190,83,2572608,5.577496,63.66409,903,323272
172.70.243.49,36464,167.235.145.223,443,141,2319329,2724,64,6300,77,2313029,37.022266,34.682232,1453,533536
172.70.243.56,48352,167.235.145.223,443,216,4234919,2696,96,8616,120,4226303,35.16261,32.274192,2135,1047599
172.70.243.60,37020,167.235.145.223,443,185,6972584,631,75,8041,110,6964543,1.259396,69.733727,922,798987
172.70.243.66,28514,167.235.145.223,443,252,4966508,2527,115,9870,137,4956638,29.167981,32.08785,2460,1235766
172.70.243.71,12384,167.235.145.223,443,6,427,1121,2,132,4,295,5.420477,29.588202,35,79
172.70.243.71,17278,167.235.145.223,443,159,2899190,3496,70,6847,89,2892343,74.12189,1.047615,52286,22087068
172.70.243.88,36664,167.235.145.223,443,162,2724649,3014,78,7390,84,2717259,51.14938,8.30378,7119,2617852
172.70.243.95,39044,167.235.145.223,443,6,427,968,2,132,4,295,3.598907,29.976621,35,78
172.70.243.97,62244,167.235.145.223,443,235,4067435,2812,114,9804,121,4057631,41.170088,32.111932,2442,1010871
172.70.243.99,59444,167.235.145.223,443,191,3522032,2604,89,8081,102,3513951,31.071316,33.450536,1932,840393
172.70.243.102,40088,167.235.145.223,443,343,6813806,1816,172,14572,171,6799234,17.159789,62.055813,1878,876531
172.70.243.103,18542,167.235.145.223,443,7,493,2465,3,198,4,295,28.030227,29.789189,53,79
172.70.243.130,10296,167.235.145.223,443,6,427,1120,2,132,4,295,5.415373,29.542959,35,79
172.70.243.139,27762,167.235.145.223,443,111,1219128,2897,54,4919,57,1214209,45.204277,30.244363,1301,321172
172.70.243.146,21298,167.235.145.223,443,235,7405703,1468,114,10093,121,7395610,11.093265,62.105246,1300,952655
172.70.243.156,62406,167.235.145.223,443,262,4775080,3061,134,11124,128,4763956,53.177735,2.162451,41153,17624282
172.70.243.179,53404,167.235.145.223,443,312,6510897,2292,129,11397,183,6499500,25.081937,33.36115,2732,1558579
172.70.243.181,24906,167.235.145.223,443,6,427,994,2,132,4,295,3.99499,29.934427,35,78
172.70.243.198,37398,167.235.145.223,443,246,4429687,2976,118,9995,128,4419692,49.076255,33.965184,2354,1040993
172.70.243.200,54216,167.235.145.223,443,132,2168196,3248,62,6319,70,2161877,62.267472,1.123722,44986,15390831
172.70.243.205,15718,167.235.145.223,443,223,4590889,3468,94,8411,129,4582478,73.080217,4.72431,14242,7759826
172.70.243.210,51144,167.235.145.223,443,227,4332382,3101,102,9147,125,4323235,55.086173,4.244836,17238,8147754
172.70.243.226,17974,167.235.145.223,443,481,10097608,1085,221,19653,260,10077955,5.154746,72.672702,2163,1109407
172.70.246.2,49828,167.235.145.223,443,187,2327212,961,91,7527,96,2319685,3.507124,60.031205,1003,309130
172.70.246.17,31286,167.235.145.223,443,6,427,1357,2,132,4,295,8.923097,29.96525,35,78
172.70.246.24,34672,167.235.145.223,443,48,30399,611,32,15534,16,14865,1.189554,78.478681,1583,1515
172.70.246.25,53428,167.235.145.223,443,48,30243,749,32,15422,16,14821,1.654199,78.989022,1561,1501
172.70.246.37,57160,167.235.145.223,443,82,2372393,2424,43,3717,39,2368676,26.936354,48.96024,607,387036
172.70.246.41,26666,167.235.145.223,443,256,4719840,1743,120,10300,136,4709540,15.880238,63.095403,1305,597132
172.70.246.46,44858,167.235.145.223,443,247,4586616,2180,116,10020,131,4576596,23.188476,31.814038,2519,1150836
172.70.246.54,36912,167.235.145.223,443,102,64780,307,68,33208,34,31572,0.514574,80.688727,3292,3130
172.70.246.54,39128,167.235.145.223,443,105,66502,142,70,34079,35,32423,0.228533,82.310635,3312,3151
172.70.246.81,64706,167.235.145.223,443,252,155931,391,168,78113,84,77818,0.676651,80.485188,7764,7734
172.70.246.86,53008,167.235.145.223,443,6,427,662,2,132,4,295,1.363928,29.626583,35,79
172.70.246.93,37058,167.235.145.223,443,165,2313676,3619,74,6414,91,2307262,81.394014,0.0655,783389,281802992
172.70.246.95,26570,167.235.145.223,443,231,4067233,2813,112,9734,119,4057499,41.172915,31.830783,2446,1019767
172.70.246.102,16184,167.235.145.223,443,90,56980,651,60,29187,30,27793,1.335978,78.403489,2978,2835
172.70.246.115,61596,167.235.145.223,443,165,2899569,3465,78,7358,87,2892211,72.906469,2.037023,28897,11358579
172.70.246.120,45152,167.235.145.223,443,171,2422595,1363,70,6150,101,2416445,9.047542,60.027866,819,322043
172.70.246.123,58406,167.235.145.223,443,267,4949187,1403,127,10369,140,4938818,10.188596,60.990905,1360,647810
172.70.246.134,32384,167.235.145.223,443,139,2319200,2712,65,6368,74,2312832,36.253534,32.658145,1559,566555
172.70.246.140,23014,167.235.145.223,443,306,6839206,3291,141,12194,165,6827012,65.206878,10.229674,9536,5338986
172.70.246.143,17654,167.235.145.223,443,166,2664641,1553,78,7363,88,2657278,12.521592,62.371945,944,340829
172.70.246.144,12688,167.235.145.223,443,6,427,922,2,132,4,295,2.867988,29.993385,35,78
172.70.246.155,35310,167.235.145.223,443,161,2120573,2780,75,6471,86,2114102,39.534262,30.293937,1708,558290
172.70.246.157,33406,167.235.145.223,443,6,427,2062,2,132,4,295,20.921356,29.955181,35,78
172.70.246.157,50454,167.235.145.223,443,235,4395986,3147,112,9801,123,4386185,57.429151,5.958319,13159,5889157
172.70.246.160,64370,167.235.145.223,443,235,5096416,2973,109,10283,126,5086133,48.804604,20.610719,3991,1974170
172.70.246.164,63462,167.235.145.223,443,194,3990839,3096,89,8963,105,3981876,54.894549,8.292553,8646,3841399
172.70.246.177,41530,167.235.145.223,443,6,427,1919,2,132,4,295,19.00603,29.972315,35,78
172.70.246.201,40334,167.235.145.223,443,152,2452773,3577,76,7226,76,2445547,78.817175,2.126637,27182,9199678
172.70.246.203,9770,167.235.145.223,443,149,2428321,2835,72,6830,77,2421491,42.016364,32.913718,1660,588566
172.70.246.221,16792,167.235.145.223,443,244,4966013,2536,104,9228,140,4956785,29.200434,31.785891,2322,1247543
172.70.246.228,39840,167.235.145.223,443,223,4307751,3186,103,9140,120,4298611,59.199232,1.804754,40515,19054612
172.70.246.244,19882,167.235.145.223,443,242,4351197,3549,115,9954,127,4341243,77.202071,1.824692,43641,19033318
172.70.246.251,27708,167.235.145.223,443,6,427,2083,2,132,4,295,21.428449,29.671865,35,79
172.70.247.7,14668,167.235.145.223,443,253,4490624,1048,123,10494,130,4480130,4.940233,62.037238,1353,577734
172.70.247.9,48268,167.235.145.223,443,267,5190546,2919,125,10581,142,5179965,46.993058,32.090688,2637,1291331
172.70.247.17,45936,167.235.145.223,443,7,493,1717,3,198,4,295,15.216288,29.97099,52,78
172.70.247.25,49126,167.235.145.223,443,6,427,1371,2,132,4,295,9.347462,29.736037,35,79
172.70.247.28,18496,167.235.145.223,443,6,427,935,2,132,4,295,3.108551,29.973042,35,78
172.70.247.32,59470,167.235.145.223,443,114,4223135,1577,46,4749,68,4218386,12.980802,54.463195,697,619631
172.70.247.49,25946,167.235.145.223,443,172,2130363,1723,81,6876,91,2123487,15.386816,60.027527,916,283001
172.70.247.62,34790,167.235.145.223,443,6,427,1708,2,132,4,295,14.912793,29.961642,35,78
172.70.247.73,10882,167.235.145.223,443,57,2051313,544,20,2167,37,2049146,1.009853,60.007546,288,273185
172.70.247.88,59566,167.235.145.223,443,405,9878611,2442,189,16562,216,9862049,27.392614,27.627302,4795,2855740
172.70.247.97,38912,167.235.145.223,443,151,2169433,3218,79,7424,72,2162009,60.829717,2.085292,28481,8294316
172.70.247.104,53504,167.235.145.223,443,7,493,2181,3,198,4,295,23.198986,29.989822,52,78
172.70.247.105,17844,167.235.145.223,443,168,105991,403,112,54099,56,51892,0.698837,80.812558,5355,5137
172.70.247.126,39922,167.235.145.223,443,162,2592034,3338,82,7622,80,2584412,66.884662,2.060006,29599,10036522
172.70.247.128,29256,167.235.145.223,443,7,493,2441,3,198,4,295,27.336325,29.733502,53,79
172.70.247.135,27252,167.235.145.223,443,192,118810,184,128,59438,64,59372,0.298783,81.20638,5855,5848
172.70.247.136,65166,167.235.145.223,443,337,2176725,270,196,63934,141,2112791,0.443466,81.186686,6299,208190
172.70.247.143,11398,167.235.145.223,443,165,2220284,3018,74,6414,91,2213870,51.389465,30.093681,1705,588527
172.70.247.151,40042,167.235.145.223,443,165,100137,912,110,49103,55,51034,2.764146,79.158254,4962,5157
172.70.247.165,20492,167.235.145.223,443,225,142047,488,150,72561,75,69486,0.881309,80.66504,7196,6891
172.70.247.165,42996,167.235.145.223,443,228,143631,418,152,73227,76,70404,0.725334,80.946479,7237,6958
172.70.247.168,44732,167.235.145.223,443,161,2387111,281,81,7561,80,2379550,0.456967,62.427976,968,304933
172.70.247.173,50442,167.235.145.223,443,165,2881526,2592,76,7231,89,2874295,30.600949,32.34762,1788,710851
172.70.247.182,50020,167.235.145.223,443,60,2453603,2259,21,2950,39,2450653,24.501595,32.430303,727,604534
172.70.247.188,25014,167.235.145.223,443,335,7286671,1835,176,15728,159,7270943,17.342369,55.675701,2259,1044756
172.70.247.193,28038,167.235.145.223,443,158,2471253,1176,75,7165,83,2464088,6.477996,62.405339,918,315881
172.70.247.196,36744,167.235.145.223,443,63,39947,971,42,20492,21,19455,3.637353,77.655398,2111,2004
172.70.247.196,51116,167.235.145.223,443,63,40318,940,42,20860,21,19458,3.195319,78.021861,2138,1995
172.70.247.207,14462,167.235.145.223,443,143,1766820,2651,68,6018,75,1760802,33.374878,30.157281,1596,467098
172.70.247.209,37316,167.235.145.223,443,84,53474,890,56,27538,28,25936,2.547364,78.096134,2820,2656
172.70.247.210,30618,167.235.145.223,443,86,54975,505,57,28106,29,26869,0.932269,82.173461,2736,2615
172.70.250.13,43188,167.235.145.223,443,163,2537966,2922,83,7815,80,2530151,47.011158,33.217654,1882,609350
172.70.250.15,19000,167.235.145.223,443,109,1167887,2153,50,4738,59,1163149,22.972293,60.026129,631,155019
172.70.250.20,26736,167.235.145.223,443,99,63259,661,66,32618,33,30641,1.361245,79.188441,3295,3095
172.70.250.21,19122,167.235.145.223,443,99,62749,819,66,32176,33,30573,2.001457,79.019396,3257,3095
172.70.250.25,57846,167.235.145.223,443,293,6347896,2693,140,12466,153,6335430,35.134106,31.448285,3171,1611644
172.70.250.30,27122,167.235.145.223,443,253,2648228,482,157,55211,96,2593017,0.857698,80.482615,5487,257746
172.70.250.30,53516,167.235.145.223,443,244,2649449,502,148,56432,96,2593017,0.926971,81.210456,5559,255436
172.70.250.41,36474,167.235.145.223,443,404,11276997,1914,189,17840,215,11259157,18.938734,42.396723,3366,2124533
172.70.250.44,28540,167.235.145.223,443,217,2778142,2301,109,8692,108,2769450,25.206775,30.082809,2311,736487
172.70.250.51,23714,167.235.145.223,443,107,1221955,3171,50,4738,57,1217217,58.790669,0.053423,709507,182276098
172.70.250.52,36586,167.235.145.223,443,93,59584,691,62,30864,31,28720,1.472204,79.152572,3119,2902
172.70.250.59,20506,167.235.145.223,443,63,2051853,2,27,2772,36,2049081,0.000955,60.00958,369,273167
172.70.250.61,61556,167.235.145.223,443,132,1506850,2680,65,5728,67,1501122,34.746284,30.212424,1516,397484
172.70.250.63,9308,167.235.145.223,443,111,70201,406,74,35925,37,34276,0.704465,79.521214,3614,3448
172.70.250.63,61452,167.235.145.223,443,111,70297,286,74,36015,37,34282,0.465894,79.247006,3635,3460
172.70.250.65,10792,167.235.145.223,443,164,2640480,1258,77,7390,87,2633090,7.645357,63.064192,937,334020
172.70.250.69,38678,167.235.145.223,443,119,1283023,3649,59,5332,60,1277691,82.829012,0.051189,833304,199682119
172.70.250.76,21900,167.235.145.223,443,364,8716462,1473,169,15167,195,8701295,11.128142,59.443739,2041,1171029
172.70.250.86,11398,167.235.145.223,443,42,26758,782,28,13790,14,12968,1.816853,78.019699,1414,1329
172.70.250.107,61616,167.235.145.223,443,238,1232198,2847,115,9289,123,1222909,42.759651,30.122005,2467,324788
172.70.250.121,25376,167.235.145.223,443,301,6520141,3543,143,12664,158,6507477,77.144101,2.066365,49029,25193911
172.70.250.126,62500,167.235.145.223,443,165,99694,453,110,48733,55,50961,0.801064,80.280665,4856,5078
172.70.250.133,38210,167.235.145.223,443,221,3980567,1034,111,10421,110,3970146,4.808066,71.78456,1161,442451
172.70.250.137,36874,167.235.145.223,443,114,73401,168,76,38204,38,35197,0.27954,80.245792,3808,3508
172.70.250.160,55812,167.235.145.223,443,283,6094130,2808,133,12004,150,6082126,41.12991,31.858548,3014,1527282
172.70.250.170,33740,167.235.145.223,443,63,2054717,1927,27,2629,36,2052088,19.191268,60.00937,350,273569
172.70.250.173,58240,167.235.145.223,443,207,3975239,2613,95,8615,112,3966624,31.268801,48.280237,1427,657266
172.70.250.185,11510,167.235.145.223,443,148,2319855,2722,70,6760,78,2313095,36.964564,37.25112,1451,496757
172.70.250.195,39826,167.235.145.223,443,174,109587,753,116,55837,58,53750,1.673728,80.437337,5553,5345
172.70.250.196,51918,167.235.145.223,443,105,1089328,3201,53,5025,52,1084303,59.669292,0.051377,782451,168838663
172.70.250.197,39362,167.235.145.223,443,6,427,2307,2,132,4,295,25.294863,29.972616,35,78
172.70.250.202,60408,167.235.145.223,443,6,427,1934,2,132,4,295,19.28205,29.932647,35,78
172.70.250.204,24496,167.235.145.223,443,123,1394875,3076,60,5487,63,1389388,53.689525,0.053868,814880,206339645
172.70.250.204,56876,167.235.145.223,443,6,427,1331,2,132,4,295,8.465855,29.614597,35,79
172.70.250.207,40438,167.235.145.223,443,117,1367349,2961,53,5025,64,1362324,47.71157,30.506208,1317,357258
172.70.250.210,46396,167.235.145.223,443,90,2654414,1575,42,4261,48,2650153,12.942109,66.838305,510,317201
172.70.250.217,60110,167.235.145.223,443,39,24901,862,26,12857,13,12044,2.270676,75.45383,1363,1276
172.70.250.228,26344,167.235.145.223,443,42,26943,916,28,13972,14,12971,2.818391,78.042625,1432,1329
172.70.250.228,42056,167.235.145.223,443,39,24599,1149,26,12558,13,12041,5.980223,72.066197,1394,1336
172.70.250.239,10312,167.235.145.223,443,160,2120484,2729,71,6184,89,2114300,37.226509,30.446631,1624,555542
172.70.250.240,15534,167.235.145.223,443,6,427,1579,2,132,4,295,13.052545,29.988044,35,78
172.70.250.243,28392,167.235.145.223,443,115,1206664,2507,58,5266,57,1201398,28.859608,30.355623,1387,316619
172.70.251.2,14580,167.235.145.223,443,299,6872642,2172,132,11938,167,6860704,23.129079,31.25187,3055,1756235
172.70.251.4,45972,167.235.145.223,443,167,2881583,2602,79,7354,88,2874229,30.955659,37.061383,1587,620425
172.70.251.6,41574,167.235.145.223,443,167,2130001,1589,78,6646,89,2123355,13.19735,60.027241,885,282985
172.70.251.8,25008,167.235.145.223,443,119,1301189,3311,59,5421,60,1295768,65.621606,0.048555,893172,213492822
172.70.251.21,22340,167.235.145.223,443,6,427,2188,2,132,4,295,23.233145,29.834864,35,79
172.70.251.25,54874,167.235.145.223,443,109,1197994,3273,54,5002,55,1192992,64.66724,0.050983,784889,187198399
172.70.251.28,22588,167.235.145.223,443,6,427,2016,2,132,4,295,20.215166,29.630352,35,79
172.70.251.29,9692,167.235.145.223,443,179,111505,594,119,55839,60,55666,1.131488,81.181004,5502,5485
172.70.251.33,56092,167.235.145.223,443,314,6729018,1079,148,12994,166,6716024,5.124065,61.156489,1699,878536
172.70.251.35,12764,167.235.145.223,443,113,1231493,3576,55,5157,58,1226336,78.716446,0.051072,807800,192095238
172.70.251.47,9370,167.235.145.223,443,322,7779407,2937,139,12412,183,7766995,47.139743,31.968155,3106,1943683
172.70.251.50,48526,167.235.145.223,443,117,1303976,3537,55,5068,62,1298908,76.937124,0.056126,722374,185141716
172.70.251.56,60478,167.235.145.223,443,6,427,1511,2,132,4,295,11.721132,29.984392,35,78
172.70.251.57,26866,167.235.145.223,443,190,2327386,618,92,7570,98,2319816,1.232206,60.027359,1008,309167
172.70.251.62,21432,167.235.145.223,443,154,2470914,1206,73,6958,81,2463956,6.941315,66.945438,831,294443
172.70.251.65,25594,167.235.145.223,443,105,65160,533,70,32734,35,32426,0.998434,82.060008,3191,3161
172.70.251.66,38078,167.235.145.223,443,163,2353200,490,93,34589,70,2318611,0.895206,78.463389,3526,236401
172.70.251.69,13892,167.235.145.223,443,6,427,835,2,132,4,295,2.082239,29.613237,35,79
172.70.251.76,31308,167.235.145.223,443,14,7581,3556,7,1774,7,5807,77.527863,0.068007,208684,683106
172.70.251.76,57782,167.235.145.223,443,120,73357,647,80,36300,40,37057,1.317365,78.043792,3720,3798
172.70.251.79,58778,167.235.145.223,443,188,2384492,2853,95,7768,93,2376724,43.184456,30.305441,2050,627405
172.70.251.82,19286,167.235.145.223,443,197,2424279,1222,98,7966,99,2416313,7.185606,60.02887,1061,322020
172.70.251.82,44510,167.235.145.223,443,130,1455584,3457,67,5949,63,1449635,72.253997,0.053534,889005,216630178
172.70.251.85,53294,167.235.145.223,443,182,2314572,3615,89,7177,93,2307395,81.195469,0.062722,915404,294301202
172.70.251.91,64198,167.235.145.223,443,6,427,1444,2,132,4,295,10.927262,29.871445,35,79
172.70.251.96,13242,167.235.145.223,443,304,7442441,2526,129,11740,175,7430701,29.127817,31.501668,2981,1887062
172.70.251.104,22184,167.235.145.223,443,152,2464735,2284,73,6958,79,2457777,24.943647,37.231597,1495,528105
172.70.251.125,23918,167.235.145.223,443,104,995750,2787,51,4804,53,990946,40.634747,30.51223,1259,259816
172.70.251.128,26706,167.235.145.223,443,6,427,1679,2,132,4,295,14.265709,29.699025,35,79
172.70.251.132,27416,167.235.145.223,443,96,60757,487,64,31038,32,29719,0.872192,80.451721,3086,2955
172.70.251.132,46984,167.235.145.223,443,96,60943,199,64,31297,32,29646,0.317296,79.816075,3136,2971
172.70.251.137,10276,167.235.145.223,443,322,7073894,1814,150,13138,172,7060756,17.140119,61.199321,1717,922984
172.70.251.155,12302,167.235.145.223,443,6,427,1567,2,132,4,295,12.731463,29.7063,35,79
172.70.251.156,35478,167.235.145.223,443,311,7712457,3413,131,11872,180,7700585,71.138255,2.023757,46930,30440749
172.70.251.159,38328,167.235.145.223,443,144,88658,654,96,44185,48,44473,1.347248,79.659106,4437,4466
172.70.251.159,49942,167.235.145.223,443,147,89918,100,98,44516,49,45402,0.165136,81.408956,4374,4461
172.70.251.167,64308,167.235.145.223,443,6,427,2236,2,132,4,295,24.170049,29.996554,35,78
172.70.251.169,42668,167.235.145.223,443,60,38480,905,40,19950,20,18530,2.669485,76.955346,2073,1926
172.70.251.170,14084,167.235.145.223,443,60,38968,738,40,20442,20,18526,1.620726,77.486743,2110,1912
172.70.251.180,50970,167.235.145.223,443,6,427,1380,2,132,4,295,9.560252,29.584298,35,79
172.70.251.182,30132,167.235.145.223,443,304,7243368,3045,132,11742,172,7231626,52.817126,2.274975,41291,25430173
172.70.251.184,54626,167.235.145.223,443,369,9678057,3279,160,14633,209,9663424,65.131948,2.220594,52717,34813834
172.70.251.199,11272,167.235.145.223,443,156,2081029,3109,73,6316,83,2074713,55.292107,0.065638,769797,252867302
172.70.251.201,32134,167.235.145.223,443,47,1330396,837,21,2164,26,1328232,2.108404,60.007502,288,177075
172.70.251.215,23114,167.235.145.223,443,6,427,1796,2,132,4,295,16.864835,29.804829,35,79
172.70.251.227,11728,167.235.145.223,443,6,427,1608,2,132,4,295,13.482781,29.69874,35,79
172.71.94.3,21462,167.235.145.223,443,6,427,2011,2,132,4,295,20.146196,29.820934,35,79
172.71.94.11,43466,167.235.145.223,443,164,1340153,1465,84,6880,80,1333273,11.048494,60.049551,916,177623
172.71.94.13,41626,167.235.145.223,443,6,427,1833,2,132,4,295,17.292794,29.771086,35,79
172.71.94.15,11664,167.235.145.223,443,466,8988299,2127,249,20355,217,8967944,22.638982,45.732102,3560,1568778
172.71.94.18,55596,167.235.145.223,443,192,1170224,2690,118,9124,74,1161100,35.068202,30.142786,2421,308159
172.71.94.20,9138,167.235.145.223,443,7,493,1667,3,198,4,295,14.026584,29.933502,52,78
172.71.94.22,53904,167.235.145.223,443,39,23865,1100,26,11826,13,12039,5.274714,60.026897,1576,1604
172.71.94.34,33972,167.235.145.223,443,223,2386827,2877,113,8982,110,2377845,43.911989,30.24149,2376,629028
172.71.94.39,62744,167.235.145.223,443,24,15330,1461,16,7916,8,7414,11.015412,65.771678,962,901
172.71.94.43,55702,167.235.145.223,443,6,427,1097,2,132,4,295,5.22922,29.880498,35,78
172.71.94.47,52378,167.235.145.223,443,220,2305269,3490,113,8982,107,2296287,73.918466,0.115154,623999,159528075
172.71.94.51,55784,167.235.145.223,443,221,2329294,3250,113,8848,108,2320446,62.351068,0.121474,582709,152819269
172.71.94.52,63466,167.235.145.223,443,238,4225572,3054,111,10223,127,4215349,53.064829,21.102878,3875,1598018
172.71.94.57,19082,167.235.145.223,443,51,31135,713,34,15386,17,15749,1.537333,78.536863,1567,1604
172.71.94.59,64482,167.235.145.223,443,248,3435604,2998,126,10719,122,3424885,49.91459,4.848587,17685,5650941
172.71.94.61,57728,167.235.145.223,443,39,1435227,1366,15,1675,24,1433552,9.148041,50.176027,267,228563
172.71.94.70,45264,167.235.145.223,443,318,5193722,2944,157,12503,161,5181219,47.191731,32.466868,3080,1276678
172.71.94.71,34154,167.235.145.223,443,257,2605984,2947,139,10657,118,2595327,47.228261,30.318449,2812,684817
172.71.94.72,35728,167.235.145.223,443,66,40716,847,44,20338,22,20378,2.196826,77.90708,2088,2092
172.71.94.72,52384,167.235.145.223,443,69,42377,666,46,21068,23,21309,1.385937,78.857458,2137,2161
172.71.94.75,28222,167.235.145.223,443,7,493,2578,3,198,4,295,29.869098,29.635748,53,79
172.71.94.78,21588,167.235.145.223,443,160,1312922,3266,86,7206,74,1305716,64.305346,0.105855,544594,98679590
172.71.94.81,44822,167.235.145.223,443,140,4104444,48,71,6512,69,4097932,0.072915,62.984955,827,520496
172.71.94.88,56346,167.235.145.223,443,241,6759480,851,113,30687,128,6728793,2.216041,77.573109,3164,693930
172.71.94.94,49130,167.235.145.223,443,265,3563267,799,133,11181,132,3552086,1.898058,62.747912,1425,452870
172.71.94.99,42088,167.235.145.223,443,6,427,1312,2,132,4,295,8.268286,29.657597,35,79
172.71.94.106,53238,167.235.145.223,443,300,4722911,1782,149,12381,151,4710530,16.628727,62.233661,1591,605528
172.71.94.107,47654,167.235.145.223,443,211,2367618,1781,97,7554,114,2360064,16.622916,60.04952,1006,314415
172.71.94.109,21652,167.235.145.223,443,90,56020,380,60,28232,30,27788,0.658138,80.239893,2814,2770
172.71.94.117,33206,167.235.145.223,443,141,1200198,3163,68,6018,73,1194180,58.290139,0.121512,396207,78621370
172.71.94.122,40920,167.235.145.223,443,205,2507667,3539,110,9643,95,2498024,77.049062,3.130111,24645,6384499
172.71.94.124,39424,167.235.145.223,443,172,1244251,1068,95,7606,77,1236645,5.041075,60.050035,1013,164748
172.71.94.128,22766,167.235.145.223,443,7,493,2071,3,198,4,295,21.143506,29.939654,52,78
172.71.94.130,56862,167.235.145.223,443,227,2425882,3069,118,8940,109,2416942,53.310211,0.11399,627423,169624844
172.71.94.130,57642,167.235.145.223,443,6,427,859,2,132,4,295,2.259351,29.718423,35,79
172.71.94.131,29616,167.235.145.223,443,285,4836293,3063,134,11316,151,4824977,53.232035,2.226869,40652,17333671
172.71.94.133,27348,167.235.145.223,443,343,6097836,2803,179,14787,164,6083049,41.083401,32.123714,3682,1514905
172.71.94.134,16674,167.235.145.223,443,383,8277540,2632,188,16254,195,8261286,31.902739,48.3173,2691,1367839
172.71.94.140,57356,167.235.145.223,443,163,1303902,3374,86,7012,77,1296890,68.277918,0.105034,534074,98778681
172.71.94.151,42966,167.235.145.223,443,387,9232834,2161,189,16132,198,9216702,23.049809,51.221439,2519,1439506
172.71.94.154,52126,167.235.145.223,443,48,29914,269,32,15093,16,14821,0.438862,78.020268,1547,1519
172.71.94.155,40284,167.235.145.223,443,51,32676,221,34,16855,17,15821,0.364346,80.358822,1677,1575
172.71.94.158,14466,167.235.145.223,443,194,2083563,3129,91,7530,103,2076033,55.928168,0.113217,532075,146694083
172.71.94.160,53944,167.235.145.223,443,6,427,2383,2,132,4,295,26.181115,29.797052,35,79
172.71.94.167,45054,167.235.145.223,443,165,1307236,3398,88,7338,77,1299898,70.422344,0.157142,373572,66176986
172.71.94.171,19288,167.235.145.223,443,37,1356936,2427,14,1803,23,1355133,27.074641,55.488099,259,195376
172.71.94.172,54078,167.235.145.223,443,69,43070,579,46,21689,23,21381,1.092379,79.375556,2185,2154
172.71.94.179,34488,167.235.145.223,443,6,427,1712,2,132,4,295,15.093229,29.945912,35,78
172.71.94.181,26646,167.235.145.223,443,7,493,946,3,198,4,295,3.270559,29.73059,53,79
172.71.94.185,39472,167.235.145.223,443,214,2425426,1289,100,8124,114,2417302,7.915867,60.046097,1082,322059
172.71.94.186,19570,167.235.145.223,443,380,7420162,1479,184,15117,196,7405045,11.214889,61.17922,1976,968308
172.71.94.188,16174,167.235.145.223,443,57,34940,298,38,17334,19,17606,0.493438,80.596724,1720,1747
172.71.94.189,18946,167.235.145.223,443,57,35164,720,38,17492,19,17672,1.571109,81.185532,1723,1741
172.71.94.191,43064,167.235.145.223,443,214,2727883,2934,111,9370,103,2718513,47.120254,30.730341,2439,707707
172.71.94.194,14880,167.235.145.223,443,178,1509978,2776,96,7866,82,1502112,39.306796,30.116109,2089,399018
172.71.94.198,31922,167.235.145.223,443,6,427,2552,2,132,4,295,29.355255,29.721134,35,79
172.71.94.202,46404,167.235.145.223,443,48,29134,1077,32,14311,16,14823,5.112876,75.046764,1525,1580
172.71.94.203,41308,167.235.145.223,443,48,28759,1042,32,13936,16,14823,4.916506,74.559827,1495,1590
172.71.94.204,30642,167.235.145.223,443,63,39094,1019,42,19638,21,19456,4.52984,72.982823,2152,2132
172.71.94.205,45036,167.235.145.223,443,66,41403,668,44,21024,22,20379,1.392495,78.101245,2153,2087
172.71.94.208,23476,167.235.145.223,443,175,2430003,2800,84,7588,91,2422415,41.068949,30.988001,1958,625381
172.71.94.212,10408,167.235.145.223,443,213,2386168,3368,102,8256,111,2377912,68.065795,0.157288,419917,120945628
172.71.94.215,18256,167.235.145.223,443,125,997228,2873,60,5490,65,991738,43.731225,30.104001,1458,263549
172.71.94.216,20824,167.235.145.223,443,6,427,1495,2,132,4,295,11.456303,29.692737,35,79
172.71.94.218,45870,167.235.145.223,443,353,2142302,1652,183,13602,170,2128700,13.903572,60.048473,1812,283597
172.71.94.222,40172,167.235.145.223,443,108,1125999,213,67,26254,41,1099745,0.353069,82.572913,2543,106547
172.71.94.223,63892,167.235.145.223,443,105,1123731,779,65,24869,40,1098862,1.795546,78.195578,2544,112421
172.71.94.225,12188,167.235.145.223,443,410,8405993,1994,207,17583,203,8388410,19.908392,47.433537,2965,1414764
172.71.94.230,23028,167.235.145.223,443,399,7312837,3299,209,16767,190,7296070,65.242074,2.741387,48929,21291616
172.71.94.239,54542,167.235.145.223,443,21,11857,1008,14,5371,7,6486,4.274603,55.508763,774,934
172.71.94.246,42890,167.235.145.223,443,252,2780478,2366,128,9972,124,2770506,25.9296,30.155276,2645,734997
172.71.94.249,57606,167.235.145.223,443,453,9619423,2498,227,18903,226,9600520,28.676907,54.367589,2781,1412682
172.71.94.252,44350,167.235.145.223,443,258,4310191,3192,121,10458,137,4299733,59.297041,2.708247,30892,12701154
172.71.94.252,44352,167.235.145.223,443,204,2162204,3194,100,7752,104,2154452,59.418987,0.165763,374124,103977461
172.71.94.254,26826,167.235.145.223,443,165,1267910,1808,88,7144,77,1260766,17.044319,60.058089,951,167939
172.71.95.7,39152,167.235.145.223,443,143,1275646,2945,68,6018,75,1269628,47.208994,30.404682,1583,334061
172.71.95.27,11538,167.235.145.223,443,14,5971,1066,8,2994,6,2977,5.035306,68.39628,350,348
172.71.98.7,47204,167.235.145.223,443,202,3522873,2609,86,7998,116,3514875,31.161011,32.865099,1946,855588
172.71.98.19,41688,167.235.145.223,443,167,2321292,2700,77,7405,90,2313887,35.290624,32.558904,1819,568541
172.71.98.26,13284,167.235.145.223,443,198,123247,641,132,62108,66,61139,1.29095,80.012432,6209,6112
172.71.98.27,24058,167.235.145.223,443,244,1436354,354,158,63645,86,1372709,0.597629,80.558601,6320,136319
172.71.98.28,50492,167.235.145.223,443,168,105541,684,112,53670,56,51871,1.444106,80.169237,5355,5176
172.71.98.29,12224,167.235.145.223,443,168,105273,424,112,53255,56,52018,0.744953,80.153892,5315,5191
172.71.98.31,53752,167.235.145.223,443,491,11266316,3347,240,20498,251,11245818,67.308668,12.131155,13517,7416156
172.71.98.32,36310,167.235.145.223,443,280,4594785,3474,133,11119,147,4583666,73.309305,2.730702,32574,13428535
172.71.98.40,47288,167.235.145.223,443,140,1224226,2994,67,5954,73,1218272,49.704271,30.106902,1582,323718
172.71.98.44,65186,167.235.145.223,443,245,4152496,3111,108,9469,137,4143027,55.301117,2.722165,27827,12175682
172.71.98.46,61444,167.235.145.223,443,196,2781234,3064,94,8527,102,2772707,53.267176,2.543172,26823,8722043
172.71.98.62,38806,167.235.145.223,443,222,139493,398,148,70935,74,68558,0.691277,79.849723,7106,6868
172.71.98.63,37458,167.235.145.223,443,222,138927,360,148,70379,74,68548,0.617016,79.859237,7050,6866
172.71.98.71,18650,167.235.145.223,443,6,427,608,3,198,3,229,1.181617,29.996498,52,61
172.71.98.73,26952,167.235.145.223,443,39,1284712,775,14,1724,25,1282988,1.785509,60.012474,229,171029
172.71.98.89,63044,167.235.145.223,443,150,1312263,3239,73,6350,77,1305913,61.710682,0.103446,491077,100992827
172.71.98.93,18380,167.235.145.223,443,94,2654861,1484,48,4840,46,2650021,11.309606,62.500549,619,339199
172.71.98.100,14280,167.235.145.223,443,138,1284371,3487,64,5756,74,1278615,73.691141,0.107069,430077,95535775
172.71.98.110,62412,167.235.145.223,443,118,996767,2627,51,4898,67,991869,31.684761,30.224083,1296,262537
172.71.98.113,32382,167.235.145.223,443,6,427,2432,2,132,4,295,27.171165,29.707772,35,79
172.71.98.119,52498,167.235.145.223,443,368,7780906,2929,171,14257,197,7766649,47.09065,31.991571,3565,1942173
172.71.98.128,34416,167.235.145.223,443,183,113793,310,122,57214,61,56579,0.517055,81.677187,5603,5541
172.71.98.128,59124,167.235.145.223,443,180,112479,483,120,56823,60,55656,0.863089,80.779706,5627,5511
172.71.98.130,26960,167.235.145.223,443,150,91620,516,100,45293,50,46327,0.956944,79.247194,4572,4676
172.71.98.131,28634,167.235.145.223,443,150,91747,519,100,45421,50,46326,0.960043,80.361239,4521,4611
172.71.98.136,50342,167.235.145.223,443,6,427,2103,2,132,4,295,22.009607,29.973491,35,78
172.71.98.141,22564,167.235.145.223,443,299,6095201,2805,130,11822,169,6083379,41.098603,32.360765,2922,1503890
172.71.98.145,47760,167.235.145.223,443,182,2593466,3303,86,7999,96,2585467,65.366263,2.457558,26038,8416377
172.71.98.147,9166,167.235.145.223,443,6,427,1990,2,132,4,295,19.86596,29.966496,35,78
172.71.98.153,37308,167.235.145.223,443,382,7420517,1464,187,15537,195,7404980,11.035466,64.308513,1932,921181
172.71.98.160,43878,167.235.145.223,443,40,1188349,997,16,1856,24,1186493,4.044799,60.01374,247,158162
172.71.98.172,13018,167.235.145.223,443,151,1508197,2339,70,6152,81,1502045,25.69934,30.481811,1614,394214
172.71.98.174,59768,167.235.145.223,443,310,6348973,2662,140,12420,170,6336553,34.06957,33.321824,2981,1521297
172.71.98.205,26506,167.235.145.223,443,265,5414890,1935,113,10680,152,5404210,19.289304,48.444966,1763,892428
172.71.98.209,58036,167.235.145.223,443,6,427,1171,2,132,4,295,6.289222,29.833523,35,79
172.71.98.221,63604,167.235.145.223,443,6,427,1270,2,132,4,295,7.765188,29.943703,35,78
172.71.98.224,35220,167.235.145.223,443,303,6728004,1063,125,11188,178,6716816,5.030371,63.146396,1417,850951
172.71.98.229,19234,167.235.145.223,443,234,4612687,3189,109,11133,125,4601554,59.24871,20.57741,4328,1788973
172.71.98.231,33740,167.235.145.223,443,6,427,1306,2,132,4,295,8.170075,29.93925,35,78
172.71.98.246,40576,167.235.145.223,443,295,6872341,2128,114,10714,181,6861627,22.695167,35.03273,2446,1566906
172.71.98.248,15394,167.235.145.223,443,180,113833,498,120,58245,60,55588,0.907134,80.253293,5806,5541
172.71.98.249,9438,167.235.145.223,443,177,111480,526,118,56826,59,54654,0.977809,79.629423,5709,5490
172.71.98.250,63710,167.235.145.223,443,141,89217,246,94,45601,47,43616,0.399886,81.201232,4492,4297
172.71.98.251,35744,167.235.145.223,443,141,89098,614,94,45557,47,43541,1.198071,81.131505,4492,4293
172.71.99.5,21214,167.235.145.223,443,382,8008070,3432,176,14879,206,7993191,71.474922,1.90288,62553,33604603
172.71.99.8,50238,167.235.145.223,443,138,1254233,3653,64,5756,74,1248477,82.848411,0.105646,435870,94540408
172.71.99.10,55812,167.235.145.223,443,285,4757838,2857,135,11251,150,4746587,43.30436,32.711053,2751,1160852
172.71.99.12,64396,167.235.145.223,443,145,1170357,1631,70,6152,75,1164205,13.657807,60.048231,819,155102
172.71.99.13,29876,167.235.145.223,443,204,122134,385,136,59145,68,62989,0.663958,80.996302,5841,6221
172.71.99.14,62044,167.235.145.223,443,237,1477770,580,150,61630,87,1416140,1.094705,80.140021,6152,141366
172.71.99.19,24968,167.235.145.223,443,6,427,995,2,132,4,295,4.006948,29.982309,35,78
172.71.99.26,37748,167.235.145.223,443,331,7245362,3056,145,12812,186,7232550,53.097078,1.986467,51597,29127289
172.71.99.28,29392,167.235.145.223,443,6,427,366,2,132,4,295,0.629005,29.601565,35,79
172.71.99.34,13690,167.235.145.223,443,6,427,1407,2,132,4,295,10.320985,29.937606,35,78
172.71.99.36,51230,167.235.145.223,443,342,6940167,1825,176,15629,166,6924538,17.254102,64.789447,1929,855020
172.71.99.43,42198,167.235.145.223,443,162,100873,378,108,50851,54,50022,0.657526,79.47566,5118,5035
172.71.99.43,46344,167.235.145.223,443,168,104551,89,112,52668,56,51883,0.14174,81.801913,5150,5074
172.71.99.44,47954,167.235.145.223,443,165,102270,358,110,51316,55,50954,0.613312,80.553023,5096,5060
172.71.99.45,10626,167.235.145.223,443,198,124737,146,132,63590,66,61147,0.235869,79.872524,6369,6124
172.71.99.46,46230,167.235.145.223,443,198,123660,433,132,62509,66,61151,0.761881,80.689445,6197,6062
172.71.99.47,44776,167.235.145.223,443,267,4617799,3620,123,10266,144,4607533,81.415974,0.674004,121850,54688494
172.71.99.49,49370,167.235.145.223,443,139,1200068,3121,66,5888,73,1194180,55.698322,0.104195,452075,91688084
172.71.99.58,63298,167.235.145.223,443,128,4103325,656,60,5460,68,4097865,1.355512,60.698428,719,540095
172.71.99.75,34160,167.235.145.223,443,99,62618,682,66,31974,33,30644,1.436643,79.349892,3223,3089
172.71.99.75,57734,167.235.145.223,443,99,62488,582,66,31851,33,30637,1.101211,79.423645,3208,3085
172.71.99.76,29048,167.235.145.223,443,99,62588,507,66,31726,33,30862,0.938371,79.346456,3198,3111
172.71.99.77,14840,167.235.145.223,443,147,89918,664,98,44525,49,45393,1.378977,79.98565,4453,4540
172.71.99.77,27862,167.235.145.223,443,150,90792,653,100,44467,50,46325,1.346338,81.385766,4370,4553
172.71.99.82,14288,167.235.145.223,443,6,427,1750,2,132,4,295,16.026235,29.963688,35,78
172.71.99.83,35708,167.235.145.223,443,142,1359982,1260,62,5624,80,1354358,7.667623,60.046308,749,180441
172.71.99.92,29202,167.235.145.223,443,44,1330220,943,18,1988,26,1328232,3.259649,60.012346,265,177061
172.71.99.103,36236,167.235.145.223,443,153,1246201,1969,74,6416,79,1239785,19.697081,60.046003,854,165178
172.71.99.108,52200,167.235.145.223,443,371,9525989,1810,148,14635,223,9511354,17.085801,38.860079,3012,1958071
172.71.99.109,45338,167.235.145.223,443,148,2166412,316,84,31578,64,2134834,0.527662,79.923836,3160,213686
172.71.99.110,52388,167.235.145.223,443,147,2165856,864,84,32254,63,2133602,2.275572,78.010745,3307,218800
172.71.99.113,51132,167.235.145.223,443,259,4310231,3179,119,10300,140,4299931,59.09375,2.292983,35935,15002051
172.71.99.113,51144,167.235.145.223,443,206,2162336,3183,102,7884,104,2154452,59.133898,0.157027,401663,109762117
172.71.99.122,42510,167.235.145.223,443,6,427,818,2,132,4,295,1.995942,29.673859,35,79
172.71.99.124,21116,167.235.145.223,443,136,1275186,2746,61,5558,75,1269628,37.766264,30.340966,1465,334762
172.71.99.134,12558,167.235.145.223,443,335,7444451,2501,143,12628,192,7431823,28.725486,35.081869,2879,1694738
172.71.99.137,10470,167.235.145.223,443,7,493,2352,3,198,4,295,25.836126,29.943175,52,78
172.71.99.140,15424,167.235.145.223,443,318,5543469,2302,148,12090,170,5531379,25.223508,32.81999,2946,1348295
172.71.99.149,59464,167.235.145.223,443,305,4982553,1229,144,12085,161,4970468,7.30374,62.748092,1540,633704
172.71.99.163,55622,167.235.145.223,443,6,427,1376,2,132,4,295,9.481822,29.965175,35,78
172.71.99.171,39276,167.235.145.223,443,174,2430216,2816,80,7603,94,2422613,41.229842,32.60571,1865,594402
172.71.99.174,48552,167.235.145.223,443,6,427,2463,2,132,4,295,27.99711,29.995747,35,78
172.71.99.174,65126,167.235.145.223,443,267,4642114,3226,121,10327,146,4631787,61.303698,2.726892,30296,13588472
172.71.99.176,33632,167.235.145.223,443,196,2883680,2554,93,8461,103,2875219,29.367275,32.508785,2082,707554
172.71.99.182,20208,167.235.145.223,443,6,427,1672,2,132,4,295,14.056605,29.671389,35,79
172.71.99.186,18954,167.235.145.223,443,186,114197,420,124,56624,62,57573,0.73056,80.363796,5636,5731
172.71.99.186,20596,167.235.145.223,443,186,114004,503,124,56569,62,57435,0.930236,80.252136,5639,5725
172.71.99.194,44236,167.235.145.223,443,275,5187955,1093,137,13037,138,5174918,5.214688,74.809633,1394,553395
172.71.99.197,36168,167.235.145.223,443,369,7311146,3307,177,14945,192,7296201,65.396681,1.68541,70938,34632290
172.71.99.198,33860,167.235.145.223,443,280,5480742,640,127,10936,153,5469806,1.284572,62.746815,1394,697381
172.71.99.208,26124,167.235.145.223,443,177,2900474,3426,72,7075,105,2893399,71.295437,2.607565,21706,8876937
172.71.99.214,13408,167.235.145.223,443,50,28399,2855,30,12264,20,16135,43.241945,38.379815,2556,3363
172.71.99.214,15458,167.235.145.223,443,108,65981,448,72,32636,36,33345,0.791793,80.054366,3261,3332
172.71.99.214,64226,167.235.145.223,443,108,66697,612,72,33355,36,33342,1.194407,80.06372,3332,3331
172.71.99.215,18622,167.235.145.223,443,225,138079,222,150,68609,75,69470,0.365535,80.759269,6796,6881
172.71.99.215,41952,167.235.145.223,443,222,138146,259,148,69592,74,68554,0.424103,79.918887,6966,6862
172.71.99.219,58104,167.235.145.223,443,134,4311851,1594,61,5776,73,4306075,13.283432,62.75776,736,548913
172.71.102.12,14756,167.235.145.223,443,6,427,2469,2,132,4,295,28.142073,29.817872,35,79
172.71.102.21,12660,167.235.145.223,443,6,427,1633,2,132,4,295,13.696348,29.954817,35,78
172.71.102.28,22946,167.235.145.223,443,332,6458959,3160,162,13945,170,6445014,58.184824,2.682013,41595,19224407
172.71.102.31,37206,167.235.145.223,443,155,1508462,2470,74,6416,81,1502046,28.19111,30.194137,1699,397970
172.71.102.41,23206,167.235.145.223,443,267,4641808,3216,121,10022,146,4631786,60.597024,0.945227,84821,39201470
172.71.102.49,62308,167.235.145.223,443,171,2321493,2717,80,7539,91,2313954,36.693376,30.934615,1949,598411
172.71.102.54,65414,167.235.145.223,443,6,427,1481,2,132,4,295,11.235058,29.988539,35,78
172.71.102.61,54046,167.235.145.223,443,172,2430020,2846,79,7473,93,2422547,42.696346,31.353531,1906,618124
172.71.102.64,21232,167.235.145.223,443,6,427,996,2,132,4,295,4.010198,29.959691,35,78
172.71.102.75,10774,167.235.145.223,443,300,187993,624,200,95197,100,92796,1.245107,80.171671,9499,9259
172.71.102.75,35394,167.235.145.223,443,300,189917,672,200,97123,100,92794,1.400761,80.263209,9680,9248
172.71.102.75,60422,167.235.145.223,443,300,189540,460,200,96892,100,92648,0.808312,80.567659,9620,9199
172.71.102.106,31710,167.235.145.223,443,452,4780028,163,270,110212,182,4669816,0.267463,80.38799,10968,464727
172.71.102.106,43820,167.235.145.223,443,397,2496758,229,250,109775,147,2386983,0.372657,80.576526,10898,236990
172.71.102.110,11238,167.235.145.223,443,273,166421,419,182,83269,91,83152,0.729272,80.833565,8241,8229
172.71.102.110,14480,167.235.145.223,443,345,2755128,411,214,85438,131,2669690,0.710482,81.046215,8433,263522
172.71.102.111,61620,167.235.145.223,443,431,5344193,134,260,91189,171,5253004,0.210252,81.483433,8952,515737
172.71.102.112,29692,167.235.145.223,443,172,1940511,3631,77,6614,95,1933897,82.16493,0.119634,442282,129320895
172.71.102.112,29706,167.235.145.223,443,189,1941566,3632,92,7536,97,1934030,82.239378,0.1183,509619,130788165
172.71.102.118,23536,167.235.145.223,443,6,427,1747,2,132,4,295,15.987261,29.967672,35,78
172.71.102.119,60694,167.235.145.223,443,196,2781171,3095,94,8463,102,2772708,54.722905,1.056597,64077,20993495
172.71.102.120,36560,167.235.145.223,443,229,3524369,2587,111,9362,118,3515007,30.196156,31.379587,2386,896125
172.71.102.124,57098,167.235.145.223,443,145,1369202,2906,65,5822,80,1363380,46.213934,30.29903,1537,359979
172.71.102.129,15064,167.235.145.223,443,197,7430025,2459,82,7770,115,7422255,27.904679,32.244831,1927,1841474
172.71.102.135,25978,167.235.145.223,443,151,1327430,1003,71,6218,80,1321212,4.159231,60.048964,828,176017
172.71.102.138,24934,167.235.145.223,443,300,187408,7,200,94772,100,92636,0.00369,81.956802,9250,9042
172.71.102.138,39732,167.235.145.223,443,300,187371,197,200,94580,100,92791,0.316393,81.773337,9252,9077
172.71.102.144,51306,167.235.145.223,443,251,4152587,3093,118,9824,133,4142763,54.521902,1.041664,75448,31816501
172.71.102.150,22084,167.235.145.223,443,425,6898786,243,250,73081,175,6825705,0.395554,80.941327,7223,674632
172.71.102.150,35778,167.235.145.223,443,213,131089,434,142,65311,71,65778,0.76784,79.07688,6607,6654
172.71.102.151,59196,167.235.145.223,443,319,4184708,432,185,70473,134,4114235,0.761775,82.049908,6871,401144
172.71.102.166,12090,167.235.145.223,443,225,141867,365,150,72378,75,69489,0.623449,81.085767,7140,6855
172.71.102.166,39286,167.235.145.223,443,225,140899,412,150,71349,75,69550,0.711851,81.798622,6978,6802
172.71.102.166,48908,167.235.145.223,443,225,141175,353,150,71691,75,69484,0.596196,80.95271,7084,6866
172.71.102.167,13902,167.235.145.223,443,225,140042,285,150,70486,75,69556,0.462239,80.697252,6987,6895
172.71.102.169,23352,167.235.145.223,443,303,5542193,2311,136,11012,167,5531181,25.319543,30.451699,2892,1453102
172.71.102.170,59814,167.235.145.223,443,144,1275714,2784,68,6020,76,1269694,40.210442,30.460729,1581,333463
172.71.102.173,63854,167.235.145.223,443,136,1169763,1755,63,5690,73,1164073,16.171262,60.051605,758,155076
172.71.102.177,45152,167.235.145.223,443,346,6730855,1029,164,13776,182,6717079,4.768922,60.812093,1812,883650
172.71.102.178,13888,167.235.145.223,443,258,163363,228,172,83697,86,79666,0.369425,80.89899,8276,7878
172.71.102.178,24108,167.235.145.223,443,255,161072,449,170,82176,85,78896,0.792931,80.398649,8176,7850
172.71.102.183,38142,167.235.145.223,443,381,9247688,3397,156,14132,225,9233556,70.341601,11.923262,9481,6195322
172.71.102.183,58912,167.235.145.223,443,152,1360642,1401,72,6284,80,1354358,10.174276,60.052866,837,180422
172.71.102.193,50514,167.235.145.223,443,185,2472970,1168,86,7826,99,2465144,6.205201,61.494665,1018,320696
172.71.102.205,16368,167.235.145.223,443,257,4617358,3614,115,9957,142,4607401,81.040457,0.963587,82666,38252081
172.71.102.218,40102,167.235.145.223,443,6,427,1780,2,132,4,295,16.587401,29.598666,35,79
172.71.102.225,62502,167.235.145.223,443,276,4642784,705,125,10636,151,4632148,1.521848,62.444351,1362,593443
172.71.102.229,33636,167.235.145.223,443,145,1311934,3265,71,6218,74,1305716,64.235834,0.107912,460968,96798576
172.71.102.230,33384,167.235.145.223,443,605,2438057,173,372,140613,233,2297444,0.284844,82.442716,13644,222937
172.71.102.231,43228,167.235.145.223,443,411,259861,442,274,132857,137,127004,0.784172,82.209514,12928,12359
172.71.102.231,60340,167.235.145.223,443,526,4595345,214,323,137264,203,4458081,0.353617,82.185836,13361,433951
172.71.102.232,59736,167.235.145.223,443,205,7403762,1429,87,8349,118,7395413,10.762706,61.169316,1091,967205
172.71.102.237,20020,167.235.145.223,443,42,1188510,386,18,2018,24,1186492,0.664745,60.013263,269,158163
172.71.102.239,41486,167.235.145.223,443,182,2466696,2242,86,7797,96,2458899,24.255297,31.620587,1972,622100
172.71.102.248,15310,167.235.145.223,443,255,154570,300,170,75828,85,78742,0.49797,82.08974,7389,7673
172.71.102.248,36450,167.235.145.223,443,258,156844,175,172,77178,86,79666,0.288388,82.325466,7499,7741
172.71.103.3,21312,167.235.145.223,443,240,148671,239,160,74412,80,74259,0.388741,81.328309,7319,7304
172.71.103.3,40522,167.235.145.223,443,240,149719,521,160,75529,80,74190,0.963892,80.936381,7465,7333
172.71.103.4,41664,167.235.145.223,443,240,148948,567,160,74836,80,74112,1.065772,81.678982,7329,7258
172.71.103.8,61760,167.235.145.223,443,168,2453945,3532,78,7473,90,2446472,76.657534,0.964815,61964,20285522
172.71.103.9,50960,167.235.145.223,443,125,1199144,3162,56,5228,69,1193916,58.237065,0.108116,386843,88343334
172.71.103.11,26666,167.235.145.223,443,269,4431032,2969,126,10352,143,4420680,48.440611,31.185169,2655,1134046
172.71.103.21,31344,167.235.145.223,443,6,427,2485,2,132,4,295,28.50897,29.694911,35,79
172.71.103.32,19400,167.235.145.223,443,7,493,1105,3,198,4,295,5.312873,29.89029,52,78
172.71.103.37,28840,167.235.145.223,443,225,139473,91,150,69983,75,69490,0.15062,81.979629,6829,6781
172.71.103.38,10474,167.235.145.223,443,225,138745,159,150,69256,75,69489,0.26075,81.879616,6766,6789
172.71.103.38,40802,167.235.145.223,443,222,137875,466,148,69315,74,68560,0.826489,81.274025,6822,6748
172.71.103.55,19988,167.235.145.223,443,141,86135,543,93,44253,48,41882,1.008602,78.161304,4529,4286
172.71.103.55,28526,167.235.145.223,443,144,90385,422,96,45847,48,44538,0.739344,81.588903,4495,4367
172.71.103.56,37994,167.235.145.223,443,144,90493,665,96,46025,48,44468,1.38451,81.380455,4524,4371
172.71.103.58,22696,167.235.145.223,443,127,997362,2665,61,5558,66,991804,34.192122,30.177815,1473,262922
172.71.103.60,49438,167.235.145.223,443,286,4757598,3335,138,11144,148,4746454,66.672046,0.8747,101922,43411034
172.71.103.63,58388,167.235.145.223,443,266,1394949,595,171,72982,95,1321967,1.134225,80.307915,7270,131689
172.71.103.64,21776,167.235.145.223,443,231,144434,481,154,73023,77,71411,0.855189,81.804695,7141,6983
172.71.103.64,53690,167.235.145.223,443,265,1394978,769,170,72786,95,1322192,1.751865,80.249038,7256,131808
172.71.103.67,21452,167.235.145.223,443,267,4877253,3292,114,9973,153,4867280,65.208424,1.661258,48026,23439008
172.71.103.67,21460,167.235.145.223,443,215,2446472,3296,103,8247,112,2438225,65.222429,0.114383,576798,170530585
172.71.103.70,11668,167.235.145.223,443,156,4822589,1249,76,6751,80,4815838,7.53856,62.420489,865,617212
172.71.103.71,53738,167.235.145.223,443,272,4593952,3463,129,10550,143,4583402,72.758569,0.767332,109991,47785334
172.71.103.74,52234,167.235.145.223,443,257,4249794,1618,117,10108,140,4239686,13.539055,62.429647,1295,543291
172.71.103.87,20084,167.235.145.223,443,134,1223831,3028,62,5624,72,1218207,52.235068,30.113263,1494,323633
172.71.103.89,9952,167.235.145.223,443,6,427,804,2,132,4,295,1.925911,29.950024,35,78
172.71.103.93,21152,167.235.145.223,443,490,7653401,1805,235,19551,255,7633850,17.006933,60.749032,2574,1005296
172.71.103.97,12744,167.235.145.223,443,282,175185,294,188,88106,94,87079,0.4798,80.2875,8779,8676
172.71.103.97,57936,167.235.145.223,443,285,177162,215,190,89072,95,88090,0.354318,80.988962,8798,8701
172.71.103.98,37760,167.235.145.223,443,285,176870,161,190,88776,95,88094,0.262301,80.660336,8804,8737
172.71.103.102,38572,167.235.145.223,443,7,493,1395,3,198,4,295,9.982755,29.968286,52,78
172.71.103.103,11876,167.235.145.223,443,186,2665811,1539,83,7543,103,2658268,12.234532,61.377168,983,346482
172.71.103.106,22778,167.235.145.223,443,6,427,2270,2,132,4,295,24.703009,29.997331,35,78
172.71.103.113,12514,167.235.145.223,443,6,427,1957,2,132,4,295,19.584606,29.996361,35,78
172.71.103.117,36004,167.235.145.223,443,177,2593016,3336,81,7549,96,2585467,66.700392,0.901079,67021,22954409
172.71.103.126,24272,167.235.145.223,443,294,182326,342,196,91543,98,90783,0.573423,80.856758,9057,8982
172.71.103.126,33964,167.235.145.223,443,291,179429,387,194,90791,97,88638,0.668433,80.52752,9019,8805
172.71.103.126,62468,167.235.145.223,443,294,182926,37,196,92139,98,90787,0.055275,82.761698,8906,8775
172.71.103.136,15518,167.235.145.223,443,145,1305918,3395,70,6152,75,1299766,70.261084,0.107092,459567,97095282
172.71.103.138,31112,167.235.145.223,443,7,493,1112,3,198,4,295,5.362022,29.9188,52,78
172.71.103.142,54072,167.235.145.223,443,6,427,2213,2,132,4,295,23.573643,29.996253,35,78
172.71.103.159,26924,167.235.145.223,443,380,1296267,121,248,112081,132,1184186,0.195609,82.801913,10828,114411
172.71.103.159,63536,167.235.145.223,443,380,1295718,33,248,111596,132,1184122,0.049743,82.737444,10790,114494
172.71.103.160,53526,167.235.145.223,443,345,216506,128,230,109905,115,106601,0.205061,82.201107,10696,10374
172.71.103.168,55388,167.235.145.223,443,180,2725854,2971,80,7539,100,2718315,48.693771,31.248789,1930,695915
172.71.103.176,44954,167.235.145.223,443,255,4231233,2713,119,9890,136,4221343,36.282656,31.319288,2526,1078273
172.71.103.182,53716,167.235.145.223,443,310,6349054,2679,139,12436,171,6336618,34.682423,31.696463,3138,1599324
172.71.103.192,46434,167.235.145.223,443,201,2883946,2594,98,8727,103,2875219,30.682521,31.05873,2247,740588
172.71.103.202,16780,167.235.145.223,443,138,1284371,3519,63,5690,75,1278681,76.249195,0.110322,412610,92723554
172.71.103.205,27032,167.235.145.223,443,255,4123094,1953,118,10174,137,4112920,19.535542,62.440317,1303,526956
172.71.103.210,52396,167.235.145.223,443,348,7210311,3046,161,13895,187,7196416,52.910804,1.693318,65646,33999123
172.71.103.212,34224,167.235.145.223,443,133,1142392,3644,62,5612,71,1136780,82.598601,0.105209,426731,86439753
172.71.103.220,63646,167.235.145.223,443,190,2901268,3460,86,7935,104,2893333,72.680016,1.259423,50404,18378784
172.71.103.233,39462,167.235.145.223,443,149,1245937,2107,72,6284,77,1239653,22.171142,60.054169,837,165137
172.71.114.3,17146,167.235.145.223,443,248,3677978,3573,119,10910,129,3667068,78.263529,3.928108,22219,7468364
172.71.114.5,20056,167.235.145.223,443,228,2317783,3635,105,8408,123,2309375,82.37721,0.178007,377872,103788053
172.71.114.5,57852,167.235.145.223,443,6,427,2308,2,132,4,295,25.302999,29.853079,35,79
172.71.114.7,29074,167.235.145.223,443,296,4589488,2185,128,10451,168,4579037,23.218833,32.774478,2551,1117707
172.71.114.20,24836,167.235.145.223,443,189,116074,304,126,57634,63,58440,0.506364,80.761301,5709,5788
172.71.114.20,24838,167.235.145.223,443,189,115954,415,126,57588,63,58366,0.71748,82.091016,5612,5687
172.71.114.21,10758,167.235.145.223,443,189,116527,457,126,58160,63,58367,0.805714,81.897423,5681,5701
172.71.114.21,20696,167.235.145.223,443,189,117149,29,126,58781,63,58368,0.046684,80.843555,5816,5775
172.71.114.28,24002,167.235.145.223,443,236,3252160,3213,115,10529,121,3241631,60.255878,3.950612,21321,6564311
172.71.114.31,11990,167.235.145.223,443,272,2127855,2725,133,10256,139,2117599,37.069879,30.498377,2690,555465
172.71.114.32,56180,167.235.145.223,443,161,1276793,2777,64,5713,97,1271080,39.3612,30.407829,1503,334408
172.71.114.41,23864,167.235.145.223,443,333,4971857,2479,151,12250,182,4959607,28.448586,33.603963,2916,1180719
172.71.114.45,42324,167.235.145.223,443,136,5294121,858,48,6434,88,5287687,2.257907,74.082947,694,571001
172.71.114.48,60096,167.235.145.223,443,6,427,2054,2,132,4,295,20.763707,29.690405,35,79
172.71.114.53,51736,167.235.145.223,443,218,2324476,2721,104,9005,114,2315471,36.956394,30.262904,2380,612094
172.71.114.54,28398,167.235.145.223,443,265,3575252,536,124,10483,141,3564769,0.999434,72.238799,1160,394776
172.71.114.55,44752,167.235.145.223,443,183,2412577,605,75,7117,108,2405460,1.171661,80.255864,709,239779
172.71.114.57,40622,167.235.145.223,443,6,427,639,2,132,4,295,1.279591,29.870489,35,79
172.71.114.58,12336,167.235.145.223,443,235,2306213,3470,111,8804,124,2297409,73.185546,0.227226,309964,80885426
172.71.114.60,49624,167.235.145.223,443,319,5595864,3552,139,12015,180,5583849,77.233794,4.099021,23449,10897917
172.71.114.62,19418,167.235.145.223,443,345,5345998,3422,146,11639,199,5334359,71.23287,2.710477,34352,15744413
172.71.114.67,27552,167.235.145.223,443,229,2387178,3343,96,7814,133,2379364,67.109654,0.222491,280964,85553626
172.71.114.69,39402,167.235.145.223,443,233,3110343,2844,108,9182,125,3101161,42.664647,19.319513,3802,1284157
172.71.114.69,39416,167.235.145.223,443,188,3368090,2845,74,7014,114,3361076,42.694875,16.183883,3467,1661443
172.71.114.71,17666,167.235.145.223,443,171,1313607,3254,73,6307,98,1307300,62.987234,0.196181,257191,53309953
172.71.114.72,65278,167.235.145.223,443,185,1371799,2905,82,6901,103,1364898,46.035421,30.474907,1811,358300
172.71.114.75,59920,167.235.145.223,443,276,3697897,2253,128,11527,148,3686370,24.435187,33.917323,2718,869495
172.71.114.83,32956,167.235.145.223,443,256,4166526,3086,116,10564,140,4155962,54.015027,5.965844,14165,5573007
172.71.114.84,32124,167.235.145.223,443,6,427,2279,2,132,4,295,24.895415,29.994477,35,78
172.71.114.89,59284,167.235.145.223,443,6,427,1621,2,132,4,295,13.55612,29.625856,35,79
172.71.114.91,40066,167.235.145.223,443,271,3887249,3319,128,11356,143,3875893,65.852176,4.358411,20844,7114323
172.71.114.94,29920,167.235.145.223,443,281,4835770,3033,125,10463,156,4825307,52.42959,3.513211,23825,10987798
172.71.114.96,13482,167.235.145.223,443,178,1000684,2639,82,6901,96,993783,32.423022,30.428927,1814,261273
172.71.114.104,62498,167.235.145.223,443,6,427,1134,2,132,4,295,5.628531,29.807391,35,79
172.71.114.107,38388,167.235.145.223,443,421,7964670,1581,200,16868,221,7947802,13.080238,44.000004,3066,1445054
172.71.114.108,62020,167.235.145.223,443,241,2225247,2978,103,8276,138,2216971,49.188028,30.243433,2189,586433
172.71.114.111,23214,167.235.145.223,443,6,427,1322,2,132,4,295,8.379002,29.953719,35,78
172.71.114.116,23292,167.235.145.223,443,410,6650758,1477,203,16999,207,6633759,11.195717,69.219902,1964,766688
172.71.114.122,21470,167.235.145.223,443,81,2315038,588,41,3533,40,2311505,1.118962,60.022048,470,308087
172.71.114.124,11076,167.235.145.223,443,146,1284856,3514,59,5383,87,1279473,75.879876,0.169388,254232,60428035
172.71.114.127,17506,167.235.145.223,443,261,4347775,3466,119,10941,142,4336834,72.933468,3.316551,26391,10461069
172.71.114.127,58362,167.235.145.223,443,126,4103361,802,57,5429,69,4097932,1.910004,62.289057,697,526311
172.71.114.128,22116,167.235.145.223,443,233,3485751,1689,113,9774,120,3475977,14.565544,46.588324,1678,596883
172.71.114.131,60922,167.235.145.223,443,249,4081948,2967,121,11065,128,4070883,48.346101,5.189626,17057,6275416
172.71.114.133,20314,167.235.145.223,443,192,6336020,2391,91,8505,101,6327515,26.29531,43.77614,1554,1156340
172.71.114.136,35438,167.235.145.223,443,6,427,2108,2,132,4,295,22.178623,29.94263,35,78
172.71.114.144,50162,167.235.145.223,443,187,1362909,1315,82,6901,105,1356008,8.290028,60.085918,918,180542
172.71.114.147,49532,167.235.145.223,443,212,2069667,1921,85,7088,127,2062579,19.092251,60.084594,943,274623
172.71.114.161,10186,167.235.145.223,443,363,6098920,2815,179,14551,184,6084369,41.193588,34.894723,3335,1394908
172.71.114.167,36964,167.235.145.223,443,183,113196,527,122,56687,61,56509,0.980519,80.633959,5624,5606
172.71.114.167,63594,167.235.145.223,443,186,115604,472,124,58164,62,57440,0.836553,82.093587,5668,5597
172.71.114.168,38140,167.235.145.223,443,6,427,927,2,132,4,295,2.929445,29.559433,35,79
172.71.114.171,65018,167.235.145.223,443,6,427,1381,2,132,4,295,9.567384,29.931367,35,78
172.71.114.173,19076,167.235.145.223,443,132,4307013,1655,64,6621,68,4300392,13.94685,50.432144,1050,682166
172.71.114.174,22590,167.235.145.223,443,228,138532,82,152,68124,76,70408,0.125031,82.879916,6575,6796
172.71.114.175,54810,167.235.145.223,443,225,137725,616,150,68244,75,69481,1.219625,80.442093,6786,6909
172.71.114.175,55344,167.235.145.223,443,225,137534,680,150,67973,75,69561,1.43241,80.938982,6718,6875
172.71.114.179,34482,167.235.145.223,443,171,4482953,1213,74,6538,97,4476415,7.064108,48.133764,1086,743995
172.71.114.181,59430,167.235.145.223,443,218,1771718,2606,93,7616,125,1764102,31.095604,30.340946,2008,465140
172.71.114.185,21766,167.235.145.223,443,254,1368267,592,153,58806,101,1309461,1.127335,80.391258,5851,130308
172.71.114.185,27038,167.235.145.223,443,222,1367570,311,140,58506,82,1309064,0.520181,82.156805,5697,127469
172.71.114.185,62474,167.235.145.223,443,239,1367252,491,140,57844,99,1309408,0.89646,80.435565,5753,130231
172.71.114.196,27958,167.235.145.223,443,93,58952,364,62,30239,31,28713,0.621088,78.561982,3079,2923
172.71.114.196,56108,167.235.145.223,443,91,56474,15,61,28685,30,27789,0.01426,78.939012,2907,2816
172.71.114.198,60608,167.235.145.223,443,376,6000151,1089,167,13935,209,5986216,5.190401,51.562534,2162,928769
172.71.114.209,13598,167.235.145.223,443,7,493,1774,3,198,4,295,16.493145,29.945461,52,78
172.71.114.209,64038,167.235.145.223,443,162,1306997,3384,79,6703,83,1300294,69.034766,0.181455,295522,57327447
172.71.114.210,36782,167.235.145.223,443,6,427,2473,2,132,4,295,28.298765,29.79825,35,79
172.71.114.216,13704,167.235.145.223,443,204,126070,492,136,63064,68,63006,0.896845,81.387934,6198,6193
172.71.114.216,20076,167.235.145.223,443,207,125450,355,138,61528,69,63922,0.605083,81.643796,6028,6263
172.71.114.216,64910,167.235.145.223,443,207,126338,172,138,62406,69,63932,0.284374,80.553137,6197,6349
172.71.115.23,17728,167.235.145.223,443,171,1314265,264,108,45205,63,1269060,0.435198,81.250163,4450,124953
172.71.115.24,10634,167.235.145.223,443,206,2540499,158,125,44046,81,2496453,0.259828,81.162719,4341,246068
172.71.115.24,30966,167.235.145.223,443,135,84159,431,90,42467,45,41692,0.758717,81.792332,4153,4077
172.71.115.33,33758,167.235.145.223,443,144,88293,462,96,43829,48,44464,0.816765,80.093804,4377,4441
172.71.115.34,12698,167.235.145.223,443,141,87026,735,94,43414,47,43612,1.606024,78.984715,4397,4417
172.71.115.34,61382,167.235.145.223,443,144,88994,620,96,44455,48,44539,1.236303,80.277632,4430,4438
172.71.115.35,54594,167.235.145.223,443,295,4804806,3295,135,10913,160,4793893,65.220373,2.7382,31883,14005968
172.71.115.37,12176,167.235.145.223,443,172,5178813,1945,89,7226,83,5171587,19.443235,60.543972,954,683349
172.71.115.60,61144,167.235.145.223,443,6,427,1232,2,132,4,295,7.336773,29.816837,35,79
172.71.115.62,32422,167.235.145.223,443,250,2780299,2295,106,8474,144,2771825,25.118654,30.219474,2243,733785
172.71.122.26,27074,167.235.145.223,443,596,10771745,2286,271,23111,325,10748634,24.949349,56.178829,3291,1530631
172.71.122.30,13542,167.235.145.223,443,341,7018582,107,161,14796,180,7003786,0.171542,62.552902,1892,895726
172.71.122.33,45600,167.235.145.223,443,302,4879415,3297,135,11212,167,4868203,65.227342,3.017021,29729,12908635
172.71.122.51,15440,167.235.145.223,443,198,2666835,1533,88,8105,110,2658730,12.164153,69.589043,931,305649
172.71.122.52,26444,167.235.145.223,443,198,2883786,2581,83,7775,115,2876011,29.922059,30.277319,2054,759911
172.71.122.59,17126,167.235.145.223,443,6,427,1528,2,132,4,295,12.096961,29.939271,35,78
172.71.122.66,27640,167.235.145.223,443,96,60631,686,64,30990,32,29641,1.446718,76.438327,3243,3102
172.71.122.67,61766,167.235.145.223,443,96,60860,1078,64,31215,32,29645,5.114417,74.355052,3358,3189
172.71.122.70,27442,167.235.145.223,443,6,427,2262,2,132,4,295,24.522277,29.705088,35,79
172.71.122.97,31218,167.235.145.223,443,253,4237384,2698,107,9364,146,4228020,35.235978,32.981822,2271,1025539
172.71.122.99,25642,167.235.145.223,443,6,427,1173,2,132,4,295,6.347899,29.898393,35,78
172.71.122.105,9642,167.235.145.223,443,6,427,1566,2,132,4,295,12.712919,29.551446,35,79
172.71.122.119,26780,167.235.145.223,443,6,427,1151,2,132,4,295,6.023133,29.973757,35,78
172.71.122.121,53870,167.235.145.223,443,238,2318506,3610,114,9065,124,2309441,80.661239,0.18035,402107,102442628
172.71.122.124,24796,167.235.145.223,443,280,9642683,205,123,11179,157,9631504,0.332231,77.169765,1158,998474
172.71.122.127,15484,167.235.145.223,443,205,2323775,2708,96,8633,109,2315142,35.962509,30.501764,2264,607215
172.71.122.134,53254,167.235.145.223,443,6,427,2401,2,132,4,295,26.436132,29.956478,35,78
172.71.122.148,40000,167.235.145.223,443,284,4125114,2045,133,11302,151,4113812,20.644592,34.061636,2654,966204
172.71.122.154,62156,167.235.145.223,443,227,7283152,1162,110,10779,117,7272373,6.170164,73.613794,1171,790327
172.71.122.157,28296,167.235.145.223,443,6,427,2048,2,132,4,295,20.688935,29.938768,35,78
172.71.122.159,35702,167.235.145.223,443,6,427,889,2,132,4,295,2.536956,29.422437,35,80
172.71.122.170,34742,167.235.145.223,443,286,4311878,3175,137,11353,149,4300525,58.915221,3.299613,27525,10426737
172.71.122.175,10432,167.235.145.223,443,6,427,2414,2,132,4,295,26.679632,29.96736,35,78
172.71.122.190,26134,167.235.145.223,443,7,493,2018,3,198,4,295,20.242206,29.99144,52,78
172.71.122.193,59038,167.235.145.223,443,7,493,202,3,198,4,295,0.328959,29.704531,53,79
172.71.122.195,28814,167.235.145.223,443,103,1267484,689,63,22736,40,1244748,1.457239,79.027907,2301,126005
172.71.122.195,31754,167.235.145.223,443,219,1275284,542,121,26712,98,1248572,1.00853,78.665923,2716,126974
172.71.122.200,42518,167.235.145.223,443,42,27022,884,28,14042,14,12980,2.506656,78.044294,1439,1330
172.71.122.201,35172,167.235.145.223,443,42,26843,728,28,13874,14,12969,1.586033,78.033042,1422,1329
172.71.122.202,45622,167.235.145.223,443,304,4759275,2850,147,12226,157,4747049,43.000325,31.715942,3083,1197391
172.71.122.206,25446,167.235.145.223,443,126,76172,59,84,37268,42,38904,0.091909,80.721696,3693,3855
172.71.122.212,35286,167.235.145.223,443,126,80053,56,84,41146,42,38907,0.088778,80.898987,4068,3847
172.71.122.216,35722,167.235.145.223,443,108,68057,746,72,34702,36,33355,1.647452,79.577153,3488,3353
172.71.122.217,38060,167.235.145.223,443,105,66031,925,70,33530,35,32501,2.912633,78.066963,3436,3330
172.71.122.218,12628,167.235.145.223,443,153,2104916,652,92,29264,61,2075652,1.343797,78.921169,2966,210402
172.71.122.225,58914,167.235.145.223,443,290,4492992,1098,135,11212,155,4481780,5.232302,62.976056,1424,569331
172.71.122.226,64510,167.235.145.223,443,265,5079950,2826,124,12164,141,5067786,41.529014,36.885711,2638,1099132
172.71.122.231,37802,167.235.145.223,443,422,8934239,3483,202,17377,220,8916862,73.608487,6.08673,22839,11719740
172.71.122.238,55886,167.235.145.223,443,207,2781935,3087,99,8831,108,2773104,54.045067,0.233214,302932,95126501
172.71.122.242,11616,167.235.145.223,443,319,4645760,112,153,12622,166,4633138,0.177571,62.459194,1616,593429
172.71.122.248,40334,167.235.145.223,443,308,4890769,2948,145,11872,163,4878897,47.237743,32.99365,2878,1182990
172.71.123.24,17090,167.235.145.223,443,184,2171699,3208,90,8237,94,2163462,60.034942,0.168035,392156,103000541
172.71.123.25,12514,167.235.145.223,443,6,427,1888,2,132,4,295,18.311175,29.919853,35,78
172.71.123.42,50516,167.235.145.223,443,193,2521858,1878,91,8303,102,2513555,18.17538,36.200876,1834,555468
172.71.123.48,33606,167.235.145.223,443,285,4070757,2817,135,11212,150,4059545,41.232245,33.088852,2710,981489
172.71.123.51,9678,167.235.145.223,443,6,427,1677,2,132,4,295,14.20703,29.945684,35,78
172.71.123.64,32538,167.235.145.223,443,319,5344451,3423,150,12072,169,5332379,71.244269,2.500358,38624,17061169
172.71.123.73,20438,167.235.145.223,443,263,3527101,2593,128,10972,135,3516129,30.630948,32.040765,2739,877913
172.71.123.100,26266,167.235.145.223,443,197,2594430,3324,89,8171,108,2586259,65.94787,0.243447,268510,84987993
172.71.123.128,58578,167.235.145.223,443,279,4588665,2187,127,10684,152,4577981,23.230977,33.117006,2580,1105892
172.71.123.133,28660,167.235.145.223,443,305,4837452,3037,147,12013,158,4825439,52.582337,3.62377,26520,10652859
172.71.123.142,15426,167.235.145.223,443,164,4119956,30,83,22422,81,4097534,0.047007,80.734379,2221,406026
172.71.123.142,34476,167.235.145.223,443,54,35101,899,36,18426,18,16675,2.618159,76.682669,1922,1739
172.71.123.145,21086,167.235.145.223,443,114,69236,825,76,33952,38,35284,2.037525,79.342569,3423,3557
172.71.123.146,48752,167.235.145.223,443,117,71731,98,78,35606,39,36125,0.161466,81.473337,3496,3547
172.71.123.151,39224,167.235.145.223,443,111,70021,262,74,35751,37,34270,0.425762,78.693055,3634,3483
172.71.123.154,22348,167.235.145.223,443,374,4785411,917,209,28548,165,4756863,2.827526,77.633534,2941,490186
172.71.123.155,37992,167.235.145.223,443,129,81806,688,86,41975,43,39831,1.450455,78.891166,4256,4039
172.71.123.165,55220,167.235.145.223,443,6,427,1694,2,132,4,295,14.642453,29.994269,35,78
172.71.123.168,25630,167.235.145.223,443,282,4251582,1559,133,11302,149,4240280,12.629028,62.020987,1457,546947
172.71.123.182,26300,167.235.145.223,443,304,4969962,2539,144,11806,160,4958156,29.229474,32.990084,2862,1202338
172.71.123.184,52226,167.235.145.223,443,198,2455897,3566,99,8831,99,2447066,77.99094,0.206227,342573,94927085
172.71.123.200,33782,167.235.145.223,443,265,4154000,3110,127,10906,138,4143094,55.294583,1.391064,62720,23826906
172.71.123.205,19254,167.235.145.223,443,237,2904409,3449,118,10085,119,2894324,71.952236,0.24124,334438,95981561
172.71.126.88,31158,167.235.145.223,443,1152,2320040,1127,539,37205,613,2282835,5.500147,60.072967,4954,304008
172.71.126.106,19466,167.235.145.223,443,14,4285,1123,7,2072,7,2213,5.443765,66.042235,250,268
172.71.126.167,11484,167.235.145.223,443,250,2485022,1500,121,9461,129,2475561,11.52693,60.065366,1260,329715
172.71.126.182,20132,167.235.145.223,443,6,427,2573,2,132,4,295,29.78894,29.905327,35,78
172.71.130.7,64022,167.235.145.223,443,236,2330322,375,115,8987,121,2321335,0.650283,60.062855,1197,309187
172.71.130.27,44000,167.235.145.223,443,221,2070304,2055,109,8715,112,2061589,20.848209,60.063771,1160,274586
172.71.130.39,54994,167.235.145.223,443,6,427,1901,2,132,4,295,18.695882,29.968839,35,78
172.71.130.39,55006,167.235.145.223,443,78,2763856,1832,31,2916,47,2760940,17.286906,39.935998,584,553072
172.71.130.50,12768,167.235.145.223,443,7,493,1117,3,198,4,295,5.39024,29.615221,53,79
172.71.130.50,12774,167.235.145.223,443,7,493,1116,3,198,4,295,5.390134,29.761891,53,79
172.71.130.56,63348,167.235.145.223,443,223,2302323,2170,108,8516,115,2293807,23.122718,30.38766,2241,603878
172.71.130.57,12534,167.235.145.223,443,222,2302527,2158,101,8293,121,2294234,22.992825,60.06289,1104,305577
172.71.130.68,58438,167.235.145.223,443,249,2494101,2519,126,9943,123,2484158,28.957205,30.151869,2638,659105
172.71.130.69,39820,167.235.145.223,443,232,2492740,2525,112,8780,120,2483960,29.099089,30.517247,2301,651162
172.71.130.75,58638,167.235.145.223,443,212,2123939,2773,102,8253,110,2115686,38.858064,30.151557,2189,561347
172.71.130.92,50188,167.235.145.223,443,286,4070885,2802,138,11472,148,4059413,41.083148,33.009789,2780,983808
172.71.130.96,46944,167.235.145.223,443,233,2306124,3467,118,9309,115,2296815,72.998831,0.146723,507568,125232717
172.71.130.99,26224,167.235.145.223,443,6,427,587,2,132,4,295,1.117093,29.584077,35,79
172.71.130.112,15870,167.235.145.223,443,6,427,1198,2,132,4,295,6.813292,29.907787,35,78
